قِصَّة	N	story
اِسِم	N	name
مَجنُون	ADJ	madmen
حِبّ	N	love
مُنتَهَى	N	utmost
رَوعَة	N	magnificence
طَبع	N	naturally
خَيالِيّ	ADJ	imaginary
جَمِيل	ADJ	beautiful
جِدّ	N	very
نَصَح	V	advise
كِلّ	N	all
قَرا	V	read
كاتِب	N	clerk
فاتِن	ADJ	charming
جُزء	N	piece
اَوَّل	ADJ	first
كان	V	be
دَلُّوعَة	ADJ	spoilt
اَهل	N	hello
حَبّ	V	dear
تِمَتَّع	V	enjoy
اَجمَل	ADJ	more
صِفَة	N	feature
جَمال	N	beauty
خُلُق	N	character
طَيِّب	ADJ	pleasant
ذَكاء	N	cleverness
خَلَّى	V	bring_about
صَوب	N	toward
صِدق	N	sincerity
قَمَر	N	moon
كِلّ	N	all
شاف	V	see
تِخَبَّل	V	conceal
عُمر	N	self
سَنَة	N	year
عَنَى	V	mean
جامعَة	N	university
عِند	N	having
صَدِيق	N	friend
رَوح	N	same
وَحَيدَة	ADJ	digression
عَشان	N	in_order_to
كِذَى	N	like_this
اِعتَبَر	V	regard
اُخت	N	sister
شَي	N	thing
اِبتَدا	V	start
اُمّ	N	mather
حَبِيب	N	lover
هَلا	N	welcome
غُرفَة	N	rooms
طَلَع	V	appear
اَراد	V	desire
نادَى	V	call
كَلَّم	V	talk_to
رِبِيع	N	living_zones
ضَحَك	V	be_made_to_laugh
اَغار	V	be_made_jealous
وَقِت	N	time
حَضَن	V	think
قال	V	be_said
حَدّ	N	still
مِثل	N	like
اَحلَى	ADJ	better
اَروَع	ADJ	most_magnificent
عالَم	N	world
كَلام	N	speech
نِسَى	V	forget
عَزِيمَة	N	invitation
خال	N	marental_uncle
نَجاح	N	success
بِنت	N	girl
ثانَوِيّ	N	secondary
اَكِيد	ADJ	sure
قَدَّر	V	make_capable_of
راح	V	go
تِلَبَّس	V	get_dressed
لَبَس	V	get_dressed
تِمَكيَج	V	make_up
مِكياج	N	facial_make-up
خَفِيف	ADJ	slight
بَسِيط	ADJ	simple
دَخَل	V	tamper
خَلَّص	V	be_completed
كَشخَة	N	showing_off
شاء	V	wish
طالَع	V	see
خاف	V	be_afraid_(of)
حَسَد	V	envy
مِبتِسم	ADJ	smiling
حَرَكَة	N	activity
عَرَف	V	inform
حِلُو	ADJ	pleasant
مَدَح	V	laud
صَغَّر	V	belittle
شَعر	N	hair
بُنِّي	ADJ	brown
عَسَلِيّ	ADJ	honey-like
عَين	N	eye
عَسَلِيّ	N	melliferous
واسِع	ADJ	extensive
غَزال	N	gazelles
جِسم	N	body
مُتَناسِق	ADJ	ordered
عارِض	N	exhibitor
زِيّ	N	uniform
تَأَخَّر	V	come_late
دِرِيوَل	N	driver
تِرَجَّى	V	expect
سِيّارَة	N	automobile
اَحلَى	N	sweeter
جا	V	cime
سَلَّم	V	hand_over
بارَك	V	congratulate
زَين	ADJ	good
تَأخِير	N	delay
يَوم	N	some_day
اِختار	V	pick
بَذلَة	N	suit
لِبس	N	attire
تِأَخَر	V	be_late
غَطَّى	V	cover
رِقَّة	N	delicateness
حَلاوَة	N	candy
وَرا	N	behind
هَند	N	handibol
اَكبَر	ADJ	larger
غار	V	be_made_jealous
واجِد	ADJ	very
اِحتَرَم	V	rspect
خاطِر	N	mind
خَبَر	N	new
دَوام	N	duration
تَمام	ADJ	fine
مِستَغرِب	ADJ	finding_strange
بَلا	V	afflict
مِتضايِق	ADJ	annoyed
فَكَّر	V	think
صُغر	N	infancy
زِينَة	N	decoration
غِيرَة	N	jealousy
مِهِمّ	ADJ	important
حَفلَة	N	celebration
اَغلَبِيَّة	N	majority
بَيت	N	house
تِكَلَّم	V	speak
فَجأَة	N	suddenly
وَلَد	N	son
اَخ	N	brother
خَلُوق	ADJ	decent
وَسِيم	ADJ	good-looking
مِتخَبِّل	ADJ	confused
نَظرَة	N	view
قَلب	N	essence
مِلك	N	possession
اَحَد	N	sunday
غَير	N	not
مُتَيَّم	ADJ	obliged
مات	V	die
اَخِير	ADJ	last
نَبض	N	beating
لاحَظ	V	receognize
ناس	N	people
وَصَل	V	convey
حَبِيبَة	N	sweetheart
اِستَحَى	V	be_ashamed
اِحمَرّ	V	burn_red
نِزَل	V	make_descend
راس	N	rowas
دَعا	V	call
سَلام	N	greeting
عافَى	V	heal
اَبَد	N	never
فَوق	N	over
تَحِت	N	under
مَلأَك	N	angel
وَجه	N	faces
مِحمِرّ	ADJ	red
بالَغ	V	exaggerate
رَبّ	N	god
صَحَى	V	wake
عَجَّل	V	hurry_up
وَدَّى	V	make_go
مِستَشفَى	N	hospital
مَجنُون	N	crazy_man
اِستَوَى	V	be_made
تَمّ	V	remain
تَفكِير	N	think
اِذن	N	authorization
تَأَخُّر	V	delay
شَبَع	V	be_satisfied
وِدّ	N	wish
اَتَمّ	V	conclude
فَجر	N	dawn
صار	V	happen
قَعدَة	N	sitting
اِنمَلّ	V	be_boring
وِقِف	V	cease
بَعِد	N	which
مِنَزِّل	N	downloading
سَلامَة	N	song
قَصد	N	goal
طُول	N	length
رَدّ	V	make_return
كِلمَة	N	remark
عَذب	ADJ	pleasant
ساحِر	ADJ	enchanting
فَرحان	ADJ	delighted
صِغِير	ADJ	small
اخَر	ADJ	other
لَيلَة	N	nighttime
دَقّ	V	knock:call
باب	N	door
فَتَح	V	open
عَوَّر	V	injury
جايّ	ADJ	next
ساعَة	N	hour
نُصّ	N	half
بِغِي	V	want
غَرِيب	ADJ	stranger
صِغِر	N	smallness
خَطَب	V	engaged
اَخِذ	V	take
مَوت	N	death
اِبلِيس	N	devil
مِوَعي	ADJ	make_awaken
سالفَة	N	account
باكِر	N	fees
خَلاص	N	deliverance
نام	V	sleep
حِين	N	times
ثانِي	ADJ	next
قام	V	undertake
صَباح	N	in_the_morning
خَير	N	well-being
اَغلَى	ADJ	more_expensive
نُور	N	light
قَولَة	N	saying
مِنحِرِج	ADJ	shy
عَلَّق	V	comment
كَذَب	V	lie
عَيِّل	N	son
رَنّ	V	resound
مُوبايِل	N	mobile
غَلا	V	exceed
غالِي	ADJ	precious
بارِحَة	N	yesterday
عَبَر	V	talk
مَعزُوم	N	invited
بَعض	N	each_other
عَبَّر	V	express
لازِم	ADJ	necessary
حَبِيب	ADJ	sweetheart
ذَقن	V	remember
سَرَح	V	go_away
وَيل	N	distress
مِستِحِي	ADJ	embaressed
تَعال	V	let's
تَغَذَّى	V	be_nourished
سِنتَر	N	center
اِشتَرَى	V	buy
بَغَى	V	desire
شَرَى	V	purchase
سُوق	N	market
مُناسِب	ADJ	appropriate
عادَة	N	practice
صَراحَة	N	frankness
شَيء	N	thing
حَقّ	N	truth
اَخّ	N	fraternal
سَوَّى	V	be_settled
عَلامَة	N	sign
تَعَجُّب	N	amazement
مِسافِر	ADJ	traveling
دِراسَة	N	study
دارِي	ADJ	aware
اخّ	N	brother
اَصل	N	originally
مَرَّة	N	occasion
رَمسَة	N	speaking
سَمَع	V	have_listen
مُحرَج	ADJ	critical
سِرعَة	N	promptness
تأَخَّر	V	be_late
اَمكَن	V	may
اَسِف	ADJ	regret
نَبرَة	N	tone
حُزن	N	sadness
خَرَّب	V	destroy
طَلعَة	N	getting_out
حَياة	N	lives
اَبّ	N	dad
رَحَم	V	havercy_with
تَوَفَّى	V	be_taken_to_heaven
نَوبَة	N	crisis
قَلبِيّ	ADJ	hearty
جاب	V	bring
صاح	V	shout
دَمعَة	N	tearful
اَخِر	N	last
صَيَّح	V	be_made_to_cry
دَمع	N	teardrop
مَسَح	V	wipe_off
سَمَح	V	allow
ضايِق	V	annoy
تِذَكَّر	V	remember
دَوم	N	continuance
وَصَّى	V	advise
مِطَمِّن	ADJ	reassured
اِتلَبَّس	V	get_dressed
داخِل	ADJ	entering
غَناة	ADJ	precious
رَبِيعَة	N	friend
دَرَى	V	hide
اَروَح	V	smell_bad
اِتشَرَّى	V	buy
رافِع	ADJ	lifting
خَشم	N	nose
رَوح	V	make_go
مَكان	N	places
غَلَط	ADJ	wrong
مُحتَرَم	ADJ	esteemed
شَيلَة	N	headcloth
عَبايَة	N	cloak
دافِع	V	defend
طَرف	N	side
سَكَت	V	mute
مِعَصِّب	N	nervous
حَشرَة	N	quarrel
قَوم	N	nation
مِعَصِّب	ADJ	nervous
رام	V	want
واسَى	V	be_charitable
صَوت	N	voice
والِد	N	mother
مِتضايِق	N	annoyed
كُثر	N	abundance
جَلَس	V	sit
كُرسِي	N	seat
مَيِّت	ADJ	dead
صِياح	N	shout
خايِف	ADJ	afraid
يَتِيم	N	unique
اَقَلّ	ADJ	smallest
عَمّ	N	avuncular
قَصَّر	V	be_insufficient
قِدِر	V	be_able_to
مَكانَة	N	places
فَقَد	V	be_missing
مَرَض	N	disease
سَرَطان	N	crayfish
حَسّ	V	encourage
حَنان	N	affection
كِثر	N	plenty
مِتعَلَّق	ADJ	connected
اُمِّيّ	ADJ	illiterate
اَسرَع	V	hasten
حادِث	N	event
نَفس	N	soul
تِأَلَّم	V	be_distressed
دَمَّع	V	cry_tears
صَيحَة	N	cry
نَكَّت	V	ridicule
مَيِّت	N	lifeless
اَكثَر	ADJ	most
واحِد	N	some_one
نَفسِي	ADJ	psychological
مِحتاج	ADJ	in_need
سافَر	V	travel
كَمَّل	V	continue
خارِج	N	outer_part
شُوَيّ	N	small
مِتعَذِّب	N	tormented
طَلَب	V	be_requested
رَحمَة	N	compassion
قَضاء	N	spending_(time)
قَدَر	N	destiny
زاد	V	add
هَمّ	N	interest
اِشتَكَى	V	complain
مَسَك	V	catch
يَد	N	hand
حَرَم	V	prevent
تِغَدَّى	V	eat
جَوع	N	hunger
رُخصَة	N	license
حِفظ	N	guarding
مِنقِهِر	ADJ	humiliated
خَصّ	N	matter
مَساء	N	in_the_evening
اِستانَس	V	be_enraptured
اِستَأنَس	V	be_sociable
اَسلَم	V	hand_over
فارِس	N	cavalry
حِلم	N	patience
اِبتَسَم	V	smile
قاعِد	ADJ	old_women
حَرف	N	letter
هِجاء	N	invective
ضَحَّك	V	be_made_to_laugh
واعِي	ADJ	aware
نايِم	ADJ	asleep
مِنسِدِح	ADJ	lying_down
سِرِير	N	bed
تِفَضَّل	V	be_kind_enough_to
اَبي	V	want
تِضايَق	V	be_inconvenienced
قايِل	ADJ	person_who_says
اِستَعبَط	V	fool
وِحدَة	N	one
وَعَد	V	promise
قُرَيِّب	ADJ	immediate_future
زِعِل	V	get_angry
تَعبان	ADJ	poor
ثالِث	ADJ	third
اِتَّصَل	V	call
صِبِح	N	daybreak
سابِع	ADJ	seventh
نُومَة	N	sleep
مِخَرِّب	ADJ	saboteur
نَوم	N	sleep
تَعَب	N	fatigue
هَدَى	V	be_directed
تَصَلَّى	V	warm_up
رِقاد	N	sleep
مَدرَسَة	N	school
وَنّاسَة	N	lively
نَشّ	V	undertake
مَخَدَّة	N	cushion
اِجتَمَع	V	gather
بَدلَة	N	suit
مُناسبَة	N	occasion
مَوجُود	ADJ	existing
تكَشَّخ	V	decorate
جِدِيد	ADJ	new
غَدا	V	appear
حَرام	N	ill-gotten
هان	V	be_avoided
عَصر	N	period
لَحَّق	V	reach
اِستَشرَى	V	deteriorate
وافَق	V	concur
زَمان	N	duration
اِستِهزاء	N	scorn
اِسبُوع	N	week
مِتعَوِّد	ADJ	habituated
اِرتاح	V	relax
شايِف	ADJ	onlooker
اَهَمّ	ADJ	more
عَفا	V	excuse
شَبّ	V	burn
اشَّر	V	make_a_signal
اِصبَع	N	finger
فَرق	N	discrepancy
شَهر	N	month
اَحسَن	ADJ	better
مُقابلَة	N	opposite
صَحّ	ADJ	correct
نَوع	N	types
مُتَكَبِّر	ADJ	arrogant
مَرحَب	N	wellcome
مَسِنجَر	N	messenger
اَملَى	V	impose
جَرَّب	V	test
كُمبِيُوتَر	N	computer
داخِل	N	inside_of
اِنتَرنِّت	N	internet
عاش	V	experience
غَرام	N	fine
عَلَّم	V	learn
اَسَف	N	regret
ساذِج	ADJ	naive
قَصَد	V	pursue
مِبَطِّل	ADJ	stopped
عان	V	help
فِيلم	N	movie
هِندِي	ADJ	hindi
حَلَم	V	dream
تِخَيَّل	V	imagine
صِدفَة	N	chance
خَطِيب	N	orator
سَرّ	V	be_delighted
حال	N	condition
دَلَع	N	pamper
جَمَّع	V	gather
مُفَضَّل	ADJ	favorite
مِتخِبِل	ADJ	idiotic
ساكِت	ADJ	calm
سَأَل	V	ask
رَمَس	V	speak
رَقِيق	ADJ	delicate
شَيخ	N	sheikh
حَرِيم	N	harem
قَرَص	V	bite
فَضَح	V	disgrace
بلا	V	hit
جَوعان	N	hungry
اَكَل	V	meal
تَرَخَّص	V	excuse_to_go
تِأَخَّر	V	be_delayed
فَرحَة	N	joy
سَرحان	ADJ	roaming_freely
ضِحك	N	laughter
وَلهان	ADJ	bewildered
فَهَّم	V	explain
صَدَّق	V	confirm
حَلا	N	sweetness
مِشَى	V	make_walk
قَعَّد	V	sit
راوَى	V	narrate
اِتخَبَّل	V	become_insane
اَيّ	N	any
نَفَّذ	V	be_carried_out
قَصّ	V	stop
تِلِيفَون	N	phone
رَضَى	V	be_pleased
غازَل	V	deny
فاضِي	ADJ	empty
تِزَوَّج	V	get_married
بَعِيد	ADJ	far
ذَبَح	V	massacre
طاع	V	acquiesce_with
كَلَّم	N	discus
غَيَّر	V	make_change
غَبِي	ADJ	stupid
فَترَة	N	phase
خُطُوبَة	N	engagement
عَطَى	V	give
رَقَم	N	number
سالِف	N	previous
فَرَح	V	be_glad
قَدَر	V	be_able_to
تِكَذَّب	V	lie
سُهُولَة	N	ease
تَقرِيب	N	approximately
تاخَّر	V	move_aside
قَرَّر	V	resolve
غَرَض	N	goal
لَون	N	types
اَحمَر	ADJ	red
شَكل	N	types
فُستان	N	dress
ماكِياج	N	facial_make-up
فَتحَة	ADJ	clear_(color)
وَردَة	N	flower
سَفَر	N	trip
مُفاجَأَة	N	surprise
قادِم	N	proceeding
دَوَّر	V	search_(for)
لَقَى	N	offal
صاد	N	sad_(arabic_letter)
مِنظَرَة	N	mirror
صارَخ	V	scream
صَدّ	V	go
رَجُل	N	husband
مِتغَطِّي	ADJ	cover
سَكَّت	V	make_silent
هَدِيَّة	N	gift
طاح	V	go_astray
اِيد	N	hand
تِلقائِيّ	N	automatic
دُون	N	beneath
حُورِيَّة	N	houri
حَفَظ	V	maintain
تغَطَّى	V	cover
عادِي	ADJ	normal
غَلطان	ADJ	erring
بَنَّد	V	lock
حاطّ	ADJ	putting
حاضِن	ADJ	embracing
حِيلَة	N	stratagem
تِخَلَّى	V	abandon
تِوَقَّع	V	expect
بَين	N	among
عَلاقَة	N	relationship
شابّ	N	young_man
رابِع	ADJ	fourth
صاحِب	N	friend
اِستِقبال	N	receiving
حَلاة	N	candy
بارِد	ADJ	frigid
مَزَح	V	jest_with
حاطِط	ADJ	putting
ثَلّاجَة	N	refrigerator
حَطّ	V	descend
فِراشَة	N	pavilion
بُرَوش	N	broch
نَظَّف	V	clean
صَفّ	N	line
لَعْوَز	V	drive_insane
اَخَذَ	V	take
تَنظِيف	N	cleaning
مِندِمِج	ADJ	firm
اِذَّكَّر	V	remember
حَلّ	V	answer
سُؤال	N	question
اِمتَحان	N	exam
كَتَب	V	write
سَتَر	V	cover
لُؤم	N	iniquity
جَواب	N	answer
اَبلَة	N	teacher
مِعَصَّب	ADJ	nervous
عاقَب	V	punish
نَسَّخ	V	make_copy
اَيَة	N	quranic_verse
مُقَصِّر	ADJ	negligent
خَدّام	N	attendant
حَسب	N	calculation
مِعَلِّمَة	N	teaching
كِتابَة	N	writing
خُصُوصِيَّة	N	unique_characteristic
نُسخَة	N	replica
تَنامِي	N	gradual_growth
مِتأَخِّر	ADJ	too_late
رَبع	N	go
مِسانِد	N	depending
اَثَّر	V	be_affected
جاذِبِيَّة	N	attraction
سَحَر	V	enchant
مَعقُول	ADJ	reasonable
مُستَحِيل	ADJ	impossible
اِعجاب	N	admiration
بال	N	whale
دِقِيقَة	N	minute
اَبرَك	ADJ	more
دَشّ	V	appear
فِضِل	V	be_preferable
زَعلان	ADJ	annoyed
وَلِيد	N	result
طار	V	fly
ذات	N	precisely
باس	V	kiss
شُغل	N	occupying
اِهتَمّ	V	concern
فاتِح	ADJ	clear_(color)
ثَقَل	V	oppress
جُناح	N	misdemeanor
سَماء	N	sky
اِستَخَفّ	V	lighten
اِستَخفَى	V	be_hidden
زَواج	N	marriage
مُقَصِّر	N	negligent
مُناسَبة	N	occasion
عَشاء	N	dinner
رايِح	ADJ	going
عازِم	N	inviter
اِعتَقَد	V	believe
سالِفة	N	strort
مَسَيدج	N	message
اَهِل	N	family
رَسمِي	ADJ	official
تَحَقَّق	V	materialize
مُرسِل	N	sender
حُلم	N	dream
مَلبَس	N	cloth
شَنطَة	N	suitcase
لَعَب	V	make_play
شِعر	N	poem
اِشتاق	V	love
غِياب	N	absence
عَلَى	N	above
طَرَى	V	happen
اِتدَلَّع	V	pamper
وَحِيد	ADJ	sole
بَقَى	V	remain
وَفاة	N	very
ذَكَّر	V	remind
حافِظ	ADJ	saving
رُومانسِي	ADJ	romantic
مَحجُوز	ADJ	confined
مِتِّصِل	ADJ	connected
وَناسَة	N	entertainment
عَصَبِيَّة	N	nervousness
مِحتاج	N	in_need
سَعادَة	N	happiness
اَعَزّ	ADJ	dearest
اِنسان	N	human
فَدَى	V	ransom
اَمان	N	safety
سَكّ	V	catch
اِستَغرَب	V	surprised
فَرَح	N	joy
مُفاجِئ	ADJ	unexpected
اِستِعجاب	N	amazement
حَصَل	V	obtain
جائِزَة	N	reward
مُمَيِّز	ADJ	discerning
اِنخَطَب	V	be_engaged
تِغَيَّر	V	be_changed
مَلمَح	N	features
شَغلَة	N	occupation
ضَرُورِي	ADJ	necessary
صارِخ	N	shouter
مَبرُوك	ADJ	congratulations!
عُقبَى	N	result
اِستاهَل	V	deserve
حَصَّل	V	obtain
راكِب	ADJ	going_on
اِهتِمام	N	interest
ضَرَب	V	be_hit
سُكان	N	rein
مِهتَمّ	ADJ	concerned
كُوافِيرَة	N	lady_hairdresser
مِستَأنِس	ADJ	sitting_down
شَغَّل	V	employ
اُغنِيَة	N	song
رَقَص	V	dance
صَفَّق	V	clap
اِنبَهَر	V	be_dazzled
شَبّ	N	youth
مَلِكَة	N	queen
اِحتِقار	N	contempt
رَبّانِي	ADJ	deist
قاصِد	ADJ	intending
صَكَّر	V	shut
مَحرَم	N	forbidden
طَلَّع	V	oust
ماسِك	ADJ	catching
اَوَّل	ADJ	first
قَعَد	V	sit_down
مِتغَطِّي	N	covered
ظاهِر	ADJ	going_out
ماسِك	N	withholding
خَوف	N	fear
تِوَتَّر	N	strain
جَنَّن	V	become_insane
وَقف	V	ceasing
رَجَع	V	send_back
طايِر	ADJ	meal
دَوّامَة	N	dizziness
بَدا	V	start
تَرَك	V	leave
تَزَوَّج	V	marry
صَعب	ADJ	arduous
اِشتَغَل	V	operate
بَنك	N	bank
اخِر	ADJ	other
عام	ADJ	general
اَجازَة	N	day_off
تَهَنَّى	V	congratulate
خَطِيبَة	N	fiance
فَرّ	V	be_arrested
واثِق	ADJ	confident
بَدَأ	V	start
خُطَّة	N	plane
تِهَنَّى	V	pleasant
مُدَّة	N	interval
مِتوَتِّر	ADJ	tensed
خُبث	N	malignancy
مُوافِق	ADJ	corresponding_to
عَجَب	V	please
ضِحكَة	N	laughter
نِدَم	V	repent
سازِج	ADJ	naive
خامِس	ADJ	fifth
بِرِيطانِي	ADJ	british
تَوَظَّف	V	be_employed
مُؤَهِّل	N	qualification
كِثِير	ADJ	a_lot
اَتقَن	V	perfect
لُغَة	N	languages
اِنجِلِيزِي	ADJ	english
رَهبَة	N	alarm
اِتوَظَّف	V	be_worked_and_paid
مِلَفّ	N	file
عَكس	N	opposite
مِتِّفِق	ADJ	in_agreement
تَعلِيق	N	comment
غَدا	N	lunch
صَبَر	V	make_patient
اَنِسَة	N	lady
شَرَّف	V	honor
هَوَى	N	inclination
كَيف	N	inclination
رادّ	ADJ	coming
ساق	V	be_directed_(at)
رايِق	ADJ	domestic
تِعَشَّى	V	have_dinner
فِكرَة	N	notion
اِستاذَن	V	request_authorization
سِتّ	N	lady
حُسن	N	beauty
رَقَد	V	abate
رَقَّد	V	lay_down
اَرقَد	V	make_lie_down
اِختَصَر	V	shorten
كَل	V	eat
تَصَدِّي	N	confrontation
ظَهَر	V	bring_out
مَركَز	N	centers
بُستان	N	garden
مَرَّ	V	go_through
مَحَلّ	N	stores
لَقَى	V	meet
زَحمَة	N	jam
باقِي	ADJ	remainder
سَبت	N	sabbath
اَند	N	end
خَمِيس	N	thursday
مَلَل	N	boredom
زَيّ	N	such
شافِي	V	healing
اِبتِسامَة	N	smile
عَرِيض	ADJ	wide
حَقَّق	V	interrogate
مُهِمَّة	N	task
اَصبَر	V	more
غَمَز	V	blink
واطِي	ADJ	low
ظَبط	N	seizure
حَدَّد	V	delimit
مَوقِع	N	site
ضَبط	N	precision
خاوَى	V	accompany
مانِع	ADJ	preventing
تَرَجى	V	tartar
عِشرَة	N	association
اَهبَل	ADJ	imbecile
كِتف	N	shoulder
حُرمَة	N	wife
رَبحان	ADJ	winner
عُصفُور	N	bird
حَجَر	N	stone
هَقَق	V	accomplish
شَرَب	V	drink
عَصِير	N	extract
غَصَّة	N	agony
ظَهر	N	midst
حالَة	N	condition
جايِب	ADJ	bringing
اِستَهزَأ	V	deride
تِمَدَّح	V	be_commended
تَفَضَّل	V	helprself
واقِف	ADJ	standing
دام	V	still
فَضل	N	distinction
دِشداشَة	N	man_cloth
فارَق	V	depart_from
تِقَنِيَّة	N	technique
حَمد	N	commendation
اُذُن	N	ear
عاشِق	N	fond_of
رَأي	N	opinion
دِنيا	N	world
سُولَف	V	tell_srories
سادِس	ADJ	sixth
قِصِير	ADJ	small
مِتعَشِّي	N	having_dinner
قِدّام	N	in_front_of
لابِس	ADJ	wearing
فَصّ	N	pieces
وَردِي	ADJ	pink
وَسَط	N	middle
عَرَّف	V	acquaint
كالَم	V	speak_with
تِنَهَّد	V	sigh
مِغازَلَة	N	dallying
قِسِم	V	i_swear!
خال	V	imagine
نَهار	N	daytime
مَخطُوب	ADJ	engaged
هَدا	V	calm_down
تِأَمَّل	V	contemplate
اَشَّر	V	indicate
طاوِلَة	N	tables
جَنّ	V	become_insane
بَرّا	N	abroad
خَصّ	V	stipulate
فِلم	N	movie
فَمّ	N	mouth
حَيّا	V	laud
نار	N	fire
اِستَحمَل	V	endure
اَشبِه	V	resemble
اَسمَرانِي	ADJ	tanned
ناقِص	ADJ	incomplete
اَحشَم	V	shame
قَهَر	V	defeat
مُكالمَة	N	telephone_call
كِبِير	ADJ	big
ناعِم	ADJ	smooth
بَرقَة	N	lightning
كِذبَة	N	untruth
خَجَل	N	shame
مَكر	N	cunning
اَبَى	N	desire
مُستَأنَس	N	sociable
مِكَلِّم	N	talking
عَيَّش	V	make_live
عِزّ	N	renown
دَلال	N	coquettishness
مِصَدِّق	ADJ	credible
اِخلاص	N	faithfulness
اَسمَى	V	name
لَقَب	N	nickname
تِوَتَّر	V	be_strained
صَقّ	V	shut
شِدِيد	ADJ	strong
قَطَع	V	stop
خَطّ	N	handwriting
بَطّارِيَّة	N	battery
سَبَب	N	reason
كَشَف	V	discover
تابِع	V	continue
طَرِيقَة	N	manner
نازِل	ADJ	staying
سِلِّم	N	ladder
طَرِيقَة	V	طَرِيقَة
مِترَبِّي	ADJ	well-mannered
عَصَّب	V	be_nervious
صِرِيخ	N	shouting
حاجِب	N	eyebrow
طَبِيعِي	ADJ	normal
كَم	N	some
هَدَّى	V	calm
صَمت	N	silence
تَرَدُّد	N	reluctance
حَكَّ	V	scrape
وَقَف	V	cease
نَطَق	V	utter
مُكالَمَة	N	telephone_call
رَتِّب	V	be_arranged
مَلَف	N	dossier
رِجّال	N	man
رَفَع	V	raise
دَهَش	V	surprise
سُكُوت	N	silence
مَبلَغ	N	all
مُعَيَّن	ADJ	prescribed
بِطاقَة	N	ballot
وَرَقَة	N	waraq
لَخبَطَة	N	disorder
تَخَصُّص	N	specialization
يِمِين	N	right_side
ساعَد	V	help
بِرَيك	N	break
فُسحَة	N	ample_opportunity
كافِتِيرِيا	N	cafeteria
فَضِيحَة	N	scandal
ساندَوِتش	N	sandwich
اِندَمَج	V	be_inserted
تِعَلَّق	V	pertain_to
تَنَهُّد	N	sighing
سَحَّر	V	enchant
خَسَر	V	lose
سَمَّى	V	name
خَدّ	N	side
هِوايَة	N	passion
ضَحَّى	V	be_sacrificed
اِعتَرَف	V	confess
سَجَّل	V	inscribe
شِرِيط	N	strip
مَشاعِر	N	emotion
شارِع	N	legislator
اِختَرَب	V	be_ruined
حاوَل	V	try
عانَد	V	resist
طالِع	ADJ	coming_out
تِحَرطَم	V	mutter
طَرِيق	N	way
نَظَر	N	view
وَقَّف	V	stop
كُمّ	N	sleeves
فُرصَة	N	chance
ماي	N	water
هَمَّ	V	be_important
شِيشَة	N	hookah
بِترُول	N	oil
قَرِيب	ADJ	near
كَلِّف	V	cost
حِنِّيَّة	N	tenderness
تِحَرَّك	V	be_moved
تَعَب	V	work_hard
عَدَّل	V	rectify
غُترَة	N	men_head_cloths
راكِب	N	passenger
رَحمٰن	ADJ	merciful
قَلَّد	V	entrust
شَكَر	V	thank
عاجِب	ADJ	amazing
جاز	V	stop
مُسَلسَل	N	sequence
مَكسِيكِي	ADJ	mexican
مُغلَق	ADJ	closed
مُتَّصِل	N	caller
غالِق	ADJ	closing
اِحساس	N	sensitivity
رُعب	N	fright
اَعَزّ	V	dearest
اِسلُوب	N	mod
جادّ	ADJ	serious
مِرتاح	ADJ	relaxed
صُراخ	N	shouting
قَبل	N	previously
صَكّ	V	be_closed
ضايِع	ADJ	stray
اِنقَهَر	V	be_defeated
عَدُو	N	enemy
خَرَب	N	destroyed
مَعصِيَة	N	insubordination
اِنشاف	V	think
مَشغَل	N	workshop
خاطِب	ADJ	engaging
عَزَم	V	invit
عِرس	N	wedding
فال	N	omen
اِنتَبَه	V	be_aware
حَدِيقَة	N	garden
مارّ	ADJ	walking
مِعَبَّر	N	expressing
مَدّ	V	extend
خايِف	N	afraid
رَوَّح	V	take_home
صالَة	N	hole
اَرضَى	V	make_satisfied
عاد	V	repeat
اِنتَهَى	V	be_concluded
بَدَّل	V	replace
كِتاب	N	book
اِستِئذان	N	request_for_authorization
هايم	ADJ	roaming
اَعذَب	V	sweeten
جَرح	N	wound
رَيَّح	V	rest
اِستَوعَب	V	comprehend
وِصَف	V	characterize
قَهر	N	conquest
فَسَّر	V	interpret
اِختِصار	N	shortening
اِحتاج	V	ne
نَفَع	V	be_advantageous_to
مِنقِهِر	N	humiliated
عَظِيم	ADJ	powerful
هَدَّد	V	intimidate
قَتَل	V	kill
اِنصَدَم	V	knock
بَيَّن	V	explain
جِرَح	V	be_wounded
تَهدِيد	N	threatening
مَرِيض	N	sick_people
مِحتار	ADJ	confused
ثامِن	ADJ	eighth
غَلَق	V	lock_or_bolt_shut
جالِس	ADJ	sitting_down
فَطَر	V	have_breakfast
حَظّ	N	be_fortunate
اَرَف	N	marker
داوَم	V	persevere
مِذاكرَة	N	memorization
مِقَطَّع	ADJ	cutting
مُذاكرَة	N	memorization
ذاكِر	V	study
ذاكَر	V	study
اِتِّصال	N	call
اِنفَضَح	V	be_exposed
مِرتِبِك	ADJ	confused
مِتفِجّ	ADJ	hasten
حاسِس	ADJ	feel
مُخِيف	ADJ	horrible
طَوَّل	V	lengthen
اَقنَع	V	be_persuaded
دَخِيل	N	please
وَدَّر	V	leave
خَلّ	V	pick
عَصَبِي	ADJ	nervous
عَفَى	V	excuse
اَحَرّ	ADJ	warmest
اَبرَد	ADJ	more_cold
دَخَّل	V	make_enter
اِستِعباط	N	playing_the_fool
خَبَّر	V	think
اِنكَشَف	V	discover
تِحَرَّى	V	pursue
نَتِيجَة	N	result
هَدِّي	V	be_calm
عَصَب	N	nerves
اَخِير	N	finally
طَيِّب	N	OK
مَترُوس	ADJ	filled
بَلَد	N	country
شَلّ	V	take
تِرَدَّد	V	be_repeated
مُعانَدَة	ADJ	stubbornness
غَصب	N	rape
هَمّ	V	be_ready
اَعان	V	help
اِتعَذِب	V	be_tormented
واجَه	V	face
تَمَشَّى	V	be_appropriate
دَرَج	N	ladder
طالِع	N	view
بَرَّع	N	abroad
عَفَس	V	stamp_out
اِتضارِب	V	clash
شَوفَة	N	vision
مَوقِف	N	position
نِكتَة	N	jokes
طِيطار	N	lizard
صِناعِي	ADJ	artificial
نَعل	N	soles
شَرَّد	V	displace
غَربَل	V	sift
حَشَرَة	N	insect
صَرصُور	N	cockroach
هَيِّن	ADJ	most_easy
بَحر	N	sea
جَزر	N	ebb
هادِي	ADJ	calm
سُمُوحَة	N	excuse
حاتَى	V	confused
فاهِم	ADJ	understanding
تِلفِزيَون	N	television
مِستَعجِل	ADJ	in_a_hurry
رَكَض	V	race
مُخَبَّأَة	N	hidden
سِكِّين	N	knife
اَخِذ	ADJ	taking
مِبَيِّن	ADJ	manifest
حادّ	ADJ	intense
اَكِّد	V	confirm
تِأَكَّد	V	ascertain
شَوق	N	wish
صايِر	ADJ	going_on
اَذَّى	V	damage
مُصَمِّم	ADJ	determined
واصِل	ADJ	arrived
سايِق	N	driver
تخَبَّل	V	be_confounded
سَحَب	V	pull_out
مَصِير	N	path
تاسِع	ADJ	ninth
اَسوَد	ADJ	black
لَحظَة	N	moment
لابِس	N	wearing
قَمِيص	N	shirt
كُحلِي	ADJ	dark_blue
بَنطَلُون	N	trouser
جَينز	N	jeans
كَرَه	V	hate
شَخص	N	person
مَنَّى	V	be_given_hope
اِتمَنَّى	V	wish
عاقِد	ADJ	frowning
خَوَّف	V	frighten
بَلَع	V	make_swallow
رِيق	N	saliva
صَدر	N	chest
اِتَّفَق	V	agree
تَفاهُم	N	mutual_comprehension
اِفتَرَض	V	expect
فَصَخ	V	annul
رَجا	V	request
ثار	V	arise
دَزّ	V	motivate
صاحِي	ADJ	vigilant
اَتَى	V	arrive
هداوَة	N	calm
مِتغَشِّي	ADJ	covered
عَناء	N	hardship
بَعِيد	N	unlikely
اَخِر	ADJ	other
مُصِرّ	ADJ	determined
طَعَن	V	stab
لَخبَط	V	disorganize
سِكِّينَة	N	knife
اِتلَخبَط	V	be_confused
مِتقَرَّب	ADJ	near
مَنَع	V	prevent
صُورَة	N	picture
خُوز	V	go_away
تِجَنَّن	V	become_insane
اَوَّل	N	first
لَمَس	V	touch
ذَكِيّ	ADJ	clever
سِجن	N	prison
عّذَّب	V	be_tormented
رَح	V	go
اِستَغَلّ	V	exploit
اَرض	N	earth
فَرَّى	V	cut_or_split_lengthwise
تِراب	N	dirt
قام	N	undertake
طَيحَة	N	going_astray
نَذِل	N	coward
تِجَمَّع	V	be_gathered
فَرَّق	V	differentiate
تِغَشَّى	V	be_covered
تَأنِيب	N	reprimand
ضَمِير	N	consciences
دَرب	N	path
كابُوس	N	nightmares
اِتِّفاقِيَّة	N	agreement
ضاع	V	emanate
زَعَل	V	make_annoyed
زَعَل	N	displeasure
اِرتِباك	N	involvement
اِطَّلَّع	V	aspire
حَياء	N	shame
مِنَزِّل	ADJ	descending
دِرِيشَة	N	window
اِنتَظَر	V	expect
قَرَّب	V	approximate
تَقَرَّب	V	get_close
مَزيُون	ADJ	pleasant
حِلَيوَة	ADJ	vainglorious
غاوِي	ADJ	curly
لِقاء	N	in_compensation_or_exchange_for
كَلفِت	V	deal_hastily
مُتَواضِع	ADJ	humble
اِلتَفّ	V	turn
حُضن	N	bosom
غَمَى	V	cover_with_a_roof
اِرتَجَف	V	throb
هات	V	give
دَبدُوب	N	bear
عِطر	N	perfume
هِدِيَّة	N	beauty
اِعتَذَر	V	exacuse
اِتنَهِّد	V	sigh
غَلطَة	N	mistakes
وَلَّى	V	run_out
مَرِيض	ADJ	sick_people
اِتفاجِئ	V	surprise
حاكَى	V	resemble
كاتِب	ADJ	writing
عَذَّب	V	torture
سَبّ	V	revile
كَلِّم	V	talk
عُصَيَّة	N	bacillus
اِنتَقَم	V	take_revenge
حَب	V	love
مُستَحِيل	N	impossible
ضَحِك	V	laugh
دَمَّر	V	wreck
مِسَكِّت	N	refrain_from
وِسادَة	N	cushion
عَصَب	V	fold
وَفَّر	V	throw
عاشِر	ADJ	tenth
دايَق	V	annoy
جارِح	ADJ	injuring
غَنَفَة	N	sofa
مِطَنِّش	ADJ	ignored
مِتعَوِّد	N	habituated
دايِم	ADJ	always
صادّ	ADJ	turne
قادِر	ADJ	able
اَمَر	V	prescribe
خَفّ	V	reduce
ياما	N	a_lot
مَحبُوب	N	desirable
جاوَب	V	comply
اَصعَب	ADJ	more
جُنُون	N	insanity
اِتقَطَع	V	be_interrupted
كَثَّر	V	increase
مَسِج	N	message
مُتَمَسِّك	ADJ	firm
شاكّ	ADJ	doubting
دَلِيل	N	indicator
مُقنِع	ADJ	persuasive
تِسَبَّح	V	take_a_shower
مِستَلقِي	ADJ	lie_down
حُبَّيبَة	N	seed
حَمّام	N	bath
تَفاهَم	V	understand_one_another
غَنَّى	V	sing
نَشَف	V	absorb
حَلاً	N	sweetness
دَلّ	N	coquettishness
عَيب	N	shame
وَضَّح	V	explain
زَمَن	N	duration
اِستَهبَل	V	fun
اَخرَة	N	last
تِمَنَّى	V	desire
اَنشَق	V	give_to_smell
سَبَح	V	swim
شَكّ	V	doubt
اِنهار	V	be_demolished
اِستِنكار	N	repudiation
مِكَلِّم	ADJ	talking
زِواج	N	doubling
كَلب	N	dog
سُمعَة	N	renown
حَلَف	V	swear
تِقَدَّم	V	get_on
قَدِّم	V	offer
مُغازِل	N	courter
عايِش	ADJ	living
زَوجَة	N	wife
صالِح	ADJ	applicable
خان	V	betray
اِستَمَرّ	V	last_(time)
شَكّ	N	doubt
مِشكِلَة	N	problem
نِهايَة	N	termination
حَزِين	ADJ	sad
مُدَمَّر	ADJ	destroyed
عَضّ	V	bite
ذِمَّة	N	security
تَغَزَّل	V	pet
زَوج	N	husband
مِكَّلِم	N	talking
شِيك	N	cheque
وَراء	N	behind
طلَّق	V	divorce
حَيّ	ADJ	living
مِثالِيّ	ADJ	ideal
اِتزَوَّج	V	get_married
عَزّ	V	be_dear
تزَوَّج	V	marry
تِعَرَّف	V	identify
سَعِيد	ADJ	happy
مَطعَم	N	restaurant
قائِمَة	N	index
طَعام	N	food
اخِر	ADJ	last
مِتعَجِّب	ADJ	amazed
جايِب	N	bringing
اَكل	N	meal
اِتغَدّا	V	be_nourished
جِدِّيَة	N	seriousness
طايِع	N	obedient
هدّى	V	calm_down
صارَح	V	declare
غَضَب	N	wrath
تِفاهَم	V	understand
عَنِيد	ADJ	stubborn
تَكَلَّم	V	speak
حادِي	ADJ	stem_of_one_and_eleven
سالِم	N	intact
طَنَّش	V	not_interest
سِنّ	N	ages_(of_persons)
مِتفَيِّق	ADJ	boundless
عاجَب	V	like
راعِي	N	sponsor
حَنّ	V	confess
حَشَر-ُِ	V	crow
مَناحَة	N	wailing
فَكّ	V	release
مَعنَى	N	nuances
اِستِقرار	N	stability
اِتحَكَم	V	be_controlled
عُزُوبِي	N	bachelor
مِتزَوِّج	ADJ	married
ثِقَة	N	trust
طَلَّق	V	divorce
حَمَل	V	be_pregnant
صَرَف	V	divert
راحَة	N	rest
اَحَثّ	V	feel
عايلَة	N	household
مَعرُوف	ADJ	well-known
رَفَض	V	refuse
زَينَة	ADJ	good
لِسان	N	tongues
طِوِيل	ADJ	tall
مَصلَحَة	N	advantages
اِنحَلّ	V	be_disbanded
صكَّر	V	shut
مِتلَبِّس	N	perpetrator
سار	V	dispatch
صَلَّى	V	pray
اِستِخارَة	N	seeking_guidance
فَكّ	N	release
نِسِيب	N	family_ties
اَحَسّ	V	be_perceived
مِسَوِّي	ADJ	doing
سُخرِيَة	N	ridicule
كارِه	ADJ	unwilling
ضارَب	V	speculate
اِترَجَّى	V	expect
مُتَعَجِّب	ADJ	amazed
لَعوَز	V	be_tired
خَبَّى	V	hide
مُستَعِدّ	ADJ	ready
كَسَّر	V	shatter
ذَنب	N	misdeed
فُرقا	N	separation
جَرَس	N	bell
مُنهار	ADJ	collapsing
لاحَق	V	go_after
مَلّ	V	become_impatient_with
اِفتَكّ	V	get_rid_off
اَدمَع	V	evoke_tears
بَهدَل	V	ridicule
طارِي	N	mention
دَلَع	ADJ	pamper
كَرِيم	ADJ	precious
صَلَّح	V	repair
مِتأَثِّر	ADJ	influenced
غايَظ	V	distress
خَبَل	V	confuse
وُجُود	N	existence
بَلوَى	N	misfortunes
رَفض	N	refusal
مَشغُول	ADJ	busy
اتَّصَل	V	call
مَوّال	N	financier
ضايَق	V	annoy
نِبر	N	granary
فايدَة	N	use
اَلَم	N	pain
ضِيق	N	narrowness
تَعبان	N	tired
سَكَّر	V	put_sugar_on
حاس	V	extend
هَزِيمَة	N	defeat
فَقد	N	loss
مَلَك	V	have
راقِد	ADJ	resting
وَعَّى	V	be_made_conscious
اِتسانَد	V	lean
غَسَل	V	wash
مُستَقبَلِيّ	ADJ	future
عَرُوس	N	bride
اِنتِخاب	N	election
نَسّى	V	be_forgotten
بِنَيّ	N	little_daughter
رِضاً	N	approval
شَرعِيّ	ADJ	lawful
سوَى	V	deserve
خِطبَة	N	engagement
سَعَد	V	be_delighted
غَيُور	ADJ	enthusiastic
مِتخِبِل	N	idiotic
اَفرَح	V	gladden
مَطبَخ	N	kitchen
بارِك	V	bless
هَنّا	V	congratulate
ماخِذ	N	taking
عَقل	N	mind
طَرَّش	V	sen
غايِب	ADJ	absent
ظَرف	N	charm
زَوَّج	V	couple
مُقَرَّر	ADJ	decided_upon
قَدَّم	V	bring_closer
حَدّ	V	delimit
تَكسِير	N	fracturing
حَرب	N	warfare
طايِح	ADJ	proning
مَكسِر	N	breaking
قاعِد	N	sitting
خَيال	N	fantasy
اَلهَى	V	entertain
عَوَّض	V	replace
نَسَّى	V	make_forget
شِرِيك	N	partner
حَبَى	V	love
عِرق	N	ancestry
دُميَة	N	puppet
مَعَزَّة	N	esteem
اَطاع	V	obey
عالِي	ADJ	high
كافِي	ADJ	adequate
اِثنا	ADJ	stem_of_two_and_twelve
مِتبَهدَل	ADJ	mistreated
ظُلمَة	N	darkness
ضَوء	N	light
لَيِت	N	light
قاطِع	V	be_angry_with
عاض	V	replace
جِدار	N	wall
دِيكُور	N	interior_decoration
دَرَجَة	N	level
ذَو	N	with
هَواء	N	atmosphere
تِنَفَّس	V	breathe
تِعَذَّب	V	torture
مِستَوَى	N	standard
اِتهَنَّى	V	enjoy
اِتجَنِّن	V	become_insane
اَمَل	N	wish
داس	V	step_on
شَفَقَة	N	pity
مَنطِقِي	ADJ	logical
يِتِيم	N	unique
بَنَى	V	be_built
دَمار	N	ruin
عائِلَة	N	household
طُفُولَة	N	infancy
نَفس	N	same
هَدَم	V	tear_down
جَحِيم	N	hell
عَيشَة	N	bread
سامَح	V	forgive
مِصِيبَة	N	misfortunes
اِنحَرَم	V	be_forbidden
اَفهَم	V	make_understand
اِتفَهَم	V	be_understood
حَبّ	N	seed
ثَرِيّ	ADJ	wealthy
مَثَل	N	for_example
عِلم	N	new
نِصّ	N	middle
شَخصِيَّة	N	personality
دِين	N	religion
شَوَّف	V	adorn
خُلق	N	character
اَسعَد	ADJ	happier
اِتخَبَل	V	be_touched_up
كَذا	N	many
ضَرُورَة	N	need
مِتحَجِّب	ADJ	veiled
كُحل	N	antimony
اَربِعاء	N	wednesday
شاي	N	tea
اَصغَر	ADJ	smaller
عَزِيز	ADJ	precious
طَلَب	N	request
عُطلَة	N	recess
تَسَوَّق	V	market
كَفَى	V	be_enough
قامَة	N	stature
مِصَدِّع	ADJ	be_annoyed_to
خَذ	V	take
جَوّ	N	atmosphere
رُغم	N	in_spite_of
حَلّ	N	cancellation
مُتَشائِم	ADJ	pessimistic
مُغرَم	ADJ	enamored
اِبتَعَد	V	be_far_away_(from)
كَبَر	V	augment
ثانَوِيَّة	N	senior
غُرُور	N	delusion
مِتَيِّم	ADJ	lovelorn
غاب	V	disappear
وَحد	N	alone
اَوَّل	ADJ	first
كِيس	N	sack
كِيسَة	N	bag
مُودِيل	N	pattern
عاب	V	be_defective
هَفهَف	V	be_slender
بَدَل	N	instead_of
هُجُوم	N	assault
مُعجَب	ADJ	admirer
وَسامَة	N	charm
تَزَيَّد	V	increase
مِكَفِّي	ADJ	adequate
مِلكَة	N	wedding_contract
غَزَل	N	flirtation
طاعَة	N	obedience
اَمر	N	matter
نَفِّذ	V	be_carried_out
كَثِير	N	a_lot
مِخلَب	N	claw
مَرأَة	N	woman
طُولَة	N	length
عِناد	N	stubbornness
تَحَكُّم	N	control
عاذ	V	seek_protection
وَعد	N	promises
ضَمَن	V	guarantee
تَعادَل	V	tie
دَلَّة	N	coffee_pots
وَفَر	V	be_plentiful
تَدَلَع	V	dandle
خَرَب	V	destroy
حجاب	N	veil
اَطلَع	V	aspire
اِتوَتَّر	V	be_strained
يَسار	N	left
اِستَقبَل	V	receive
مَجلِس	N	council
ثَرَى	N	earth
رِجل	N	leg
تِفَلسَف	V	philosophize
صَدمَة	N	shock
مِقابِل	ADJ	facing
بَرَكَة	N	blessing
صاصَر	V	mutter
تَجَهُّز	N	equipment
اِستِعداد	N	preparation
عَمَّة	N	paternal_aunt
عَرَّس	V	make_marry
جَهَز	V	prepare
مِبَحلِق	ADJ	staring
رَكَد	V	be_motionless
جَنَّ	V	be_crazy
عُقبى	N	consequence
اِتذَكَّر	V	remember
قَدِيم	ADJ	old
اَخَر	ADJ	other
بِدايَة	N	beginning
رِوايَة	N	story
حَقِيبَة	N	suitcase
حَذَر	N	caution
رَسَم	V	be_sketched
فَصل	N	chapter
تَلاشِي	N	vanishing
عَودَة	N	return
ماضِي	N	energetic
حُجرَة	N	compartment
سَلَّى	V	entertain
زَمِيل	N	companion
دُودَة	N	worm
ناحِيَة	N	area
اَناقَة	N	elegance
عَبقَرِيّ	ADJ	genius
مُشَوَّش	ADJ	disturbed
اِتِّكالِيّ	ADJ	dependent
نِظامِيّ	ADJ	orderly
مَشيَة	N	pace
مِزاج	N	mood
مِزاجِي	ADJ	mood
تَعامَل	V	behave
كِي	N	like_this
تَصَرَّف	V	behave
حَسَب	N	in_accordance_with
مُود	N	mood
اِعتِقاد	N	conviction
غَباء	N	stupidity
كُتلَة	N	bloc
مِتمَشِّي	ADJ	walking
رَزَق	V	endow
نِعمَة	N	blessing
مَجمُوعَة	N	bloc
مَعرَض	N	exhibition
عِنوان	N	headlines
بَطن	N	depth
بِجامَة	N	pajama
اَصفَر	ADJ	yellow
مَنقُوش	ADJ	sculptured
نَظّارَة	N	eyeglass
طِبِّيّ	ADJ	medical
مُرَبَّع	ADJ	square
اِطار	N	framework
مُتَناثِر	ADJ	dispersed
اِهمال	N	oversight
مُستَمتِع	ADJ	amused
قِراءَة	N	reading
عَبَث	V	twiddle
نَفَس	N	breath
اِضطِراب	N	disorder
اِنسانِيَّة	N	humanity
شَفّاف	ADJ	translucent
سَطر	N	line
ذاكِرَة	N	memory
كُوز	N	jug
سَقَى	V	irrigate
شَجَرَة	N	tree
اَطوَل	ADJ	taller
شاقّ	ADJ	splitting
حَلق	N	mouth
رَملَة	N	sand
تَرَقَّب	V	watch
بَراءَة	N	license
تِأَفَّف	V	grumble
بُوز	N	muzzle
رَكَب	V	get_on
نَقَز	V	hop
اِكتَفَى	V	be_satisfied_with
بٍضع	N	some
نَقَش	V	engrave
ثانِي	ADJ	another
مُبهَم	ADJ	unintelligible
دَقَّة	N	knock
ذِكرَى	N	remembrance
تَيّار	N	current
تَناسَى	V	be_oblivious_of
مِس	N	miss
مِستَر	N	mr
اِعتَدَل	V	be_balanced
جَلسَة	N	session
كَومِيدِينُو	N	cupboard
شَبّاصَة	N	hair_clips
كَثِيف	ADJ	concentrated
حافِي	ADJ	barefoot
مِتمَلِّل	ADJ	dissatisfied
اَمس	N	yesterday
تَناقَش	V	debate_each_other
مَوضُوع	N	issue
تِخَرَّج	V	be_graduated
نَفسِيّ	ADJ	psychologically
اَجبَر	V	compel
جِناح	N	wing
هَدّ	V	leave
لَمّ	V	gather
دَندَن	V	hum
فَظِيع	ADJ	heinous
مُمِلّ	ADJ	boring
كُبر	N	big
خادِم	N	attendant
عَدّ	V	count
عَدَد	N	number
مِقابِل	N	corresponding_to
بِلازما	N	plasma
قَناة	N	channel
مِوَطِّي	ADJ	lowering
جَرِيدَة	N	newspaper
قِبال	N	in_front_of
اَنِيق	ADJ	graceful
غامِض	N	vague
غُمُوض	N	vagueness
عَجَز	V	be_impotent
فِهم	N	understanding
تَرَبَّى	V	be_educated
عاجِز	ADJ	incapacitated
فَهم	N	understanding
تَفسِير	N	quranic_commentary
بان	V	emerge
عازِب	ADJ	unmarried
اِرتَبَط	V	be_connected
نِهائِيّ	ADJ	never_ever
تِكرار	N	repeatedly
مُمكِن	ADJ	possible
شابَه	V	be_similar
كامِل	ADJ	integral
سُبحان	N	praise
فِلُوس	N	money
اَباد	V	exterminate
لاقَى	V	meet
اِنقَطَع	V	stop
صافِي	ADJ	clear
اِختَفَى	V	be_hidden
تَلاشَى	V	be_destroyed
شَرا	N	like
راقَب	V	supervise
حَسرَة	N	sorrow
تَنهِيدَة	N	sighing
حَبَس	V	obstruct
اَرسَل	V	messengers
اِنذار	N	alarm
تَجَمُّع	N	assembly
سُقُوط	N	fall
هَوَّس	V	step_on
قُوَّة	N	strength
عَقّ	V	be_arrested
تَرَبَّع	V	be_seated
صَفحَة	N	pages
اِقتِصادِي	ADJ	economical
اِطّالَع	V	see
ضِعِيف	ADJ	weak
لَمَح	V	glance
خَنَق	V	choke
تِعَوَّد	V	beed_to
اَصدَر	V	issue
هَمهَمَة	N	droning
ذابِح	ADJ	slaughtering
خَنقَة	N	suppression
صَبّ	V	pour
رِيمُوت	N	remote
لَفّ	N	winding
دَوَران	N	running
مُقَدِّمَة	N	preface
رِحلَة	N	career
عِلاج	N	treatment
طال	V	be_long
قاطَع	V	interrupt
هَزّ	V	shake
اَلجَم	V	bridle
سَرَى	V	flow
رَعشَة	N	tremor
اِندِفاع	N	breaking_forth
وَعي	N	consciousness
خَرَّف	V	be_senile
حَكَم	V	judge
غَمَّض	V	close
اَنكَر	V	deny
بَطَّل	V	thwart
وِرث	N	legacy
بَرِيئ	ADJ	innocent
تَبَرّا	V	repudiate
تِحَمَّل	V	impose
جاهِل	N	infants
رَحَّب	V	receive
جَد	N	grandma
راجِع	ADJ	attributed
مِعتاد	ADJ	habitual
دار	V	concern
اَشار	V	cite
قَصر	N	palace
وَرِيث	ADJ	inheritor
مِليُونِير	N	millionaire
صَعُب	V	be_difficult
طَمعان	ADJ	desirous
عارِف	ADJ	having_knowledge_of
اَحرَص	ADJ	more_careful
اِستَولَى	V	overpower
حَلال	N	money
فِيزا	N	visa
رَبَّى	V	grow
مِتأَكِّد	ADJ	sure
اِستَحَقّ	V	deserve
نِقاش	N	debate
فَرع	N	subdivision
شَرِكَة	N	company
طامِع	ADJ	desirous
خَطا	V	step
خَطوَة	N	step
اَثبَت	V	prove
عاقِل	ADJ	sane
عالِم	ADJ	knowing
سَفرَة	N	headcloth
مِأَمِّن	ADJ	calm
اَوَّلِيّ	ADJ	foremost
غَلاة	N	dearness
صَفَع	V	be_slapped
عِدِل	ADJ	good
اِعتِراض	N	opposition
اِمتَلا	V	become_full
نَوَّر	V	light
قِرايَة	N	reading
رَبَع	V	run
ضايِج	ADJ	annoyed
شَرَد	V	wander
بُطء	N	slowness
قاسِي	ADJ	brutal
فَشَّل	V	annoy
تِجاهَل	V	feign_ignorance_of
حَسَب	V	think
وِسِخ	ADJ	dirty
عَبَس	V	grin
مِزاجِيَّة	N	mood
عابِس	ADJ	frowning
عَدَم	N	not
مُبالاة	N	concern
قابَل	V	meet
شَعبِي	ADJ	national
مُتَهالِك	ADJ	broken_down
كَهرَبَة	N	electricity
اِضطَرّ	V	forced
جار	N	neighbor
كَهرَبا	N	electricity
باع	V	sell
سَب	N	in_order_to
نَقَص	V	decrease
دَرَس	V	study
لُقمَة	N	daily_bread
عَيش	N	bread
كافَح	V	struggle_against
تِعَلَّم	V	study
كِفاح	N	battle
فِعل	N	actually
اِجتَهَد	V	strive
مُجتَهِد	ADJ	diligent
نِصِيب	N	shares
مُجازَفَة	N	reckless
خَطّ	V	inscribe
رائِع	ADJ	crystal_clear
وَفَّى	V	fulfill
راقِي	ADJ	advanced
مُعامَلَة	N	treatment
حَسَّس	V	make_feel
عالَة	N	load
تَشارَك	V	share
قَساوَة	N	severity
اِنطَرَد	V	be_dismissed
مِشتاق	ADJ	yearning
نَفَض	V	shake
ذَوق	N	tastes
اَدَقّ	ADJ	more
تَفصِيل	N	detailing
فَصَّل	V	classify
حاضِر	ADJ	OK
صَحِيح	ADJ	correct
مَملَكَة	N	kingdom
خاصّ	ADJ	special
اِستَهوَى	V	charm
شَدّ	V	strain
مَلجَأ	N	refuges
كِلاسِيكِيّ	ADJ	classic
دائِرِيّ	ADJ	ring-shaped
سِيدِي	N	cds
مَعزُوفَة	N	recital
اِستَثار	V	elicit
مُعظَم	N	most
عِلمِي	ADJ	scientific
تارِيخِيّ	ADJ	historical
رَوحِيّ	ADJ	alcoholic
فَلسَفَة	N	philosophy
بَحَث	V	search_(for)
طَوَّر	V	promote
عَدوَى	N	infection
شَقا	N	distress
ناقَش	V	debate
بَعض	N	each_other
حَلَّل	V	allow
مَسح	N	deletion
تَجمِيعِي	ADJ	joining
اَلِيم	ADJ	cruel
خَيَّل	V	give_the_impression
مَربُوط	ADJ	connected
خَيط	N	string
رَفِيع	ADJ	delicate
غَمَس	V	plunge
حَرَق	V	grin
تَقَرُّح	N	ulceration
فُضُول	N	indiscretion
قامُوس	N	dictionary
وَجَد	V	fin
داخِلَة	N	innermost_minds
نِساء	N	woman
اَخفَى	V	hide
كائِن	N	living_being
اَخَصّ	ADJ	more_specific
بِعَد	V	away
شَرّ	N	malice
بَوَّابَة	N	gate
مَطار	N	airfield
بُرُود	N	coldness
ظاهِرِي	ADJ	external
مُختَلِف	ADJ	various
مُلتَهِب	ADJ	burning
سابَق	V	race_with
تَعاسَة	N	misery
اَهَة	N	sigh
مُتَوالِي	ADJ	successive
مُتَعَذِّر	ADJ	apologizing
عَدَسَة	N	lens
تَنَبَّه	V	become_aware
اِنزال	N	landing
قَطرَة	N	drop
بَلَل	N	moisture
فِراق	N	separation
مَوسِم	N	phase
مَدّ	N	lengthening
عانَق	V	embrace
مُجرِم	ADJ	criminal
بَطِيء	ADJ	slow
سايِر	ADJ	marching
رَبَت	V	caress
خَربَط	V	confuse
قَرَّب	N	proximity
اَسَى	N	sadness
مُرَبِّي	N	pedagogue
نِسبَة	N	percentage_figure
تَوصِيَة	N	advice
حان	V	arrive
جِهَة	N	institution
صارَع	V	fight_against
تِحَدَّى	V	provoke
فاز	V	win
جَبَر	V	restore
جَبَرُوت	N	omnipotence
سُلطَة	N	authority
تَعصِيب	N	fanaticism
كُره	N	hatred
تَساءَل	V	ask
سَخِيف	ADJ	stupid
مُتَناقِض	ADJ	contradictory
تَضادّ	V	oppose_each_other
تِصَرَّف	N	measures
بَساطَة	N	frankness
عَنجَهِي	ADJ	arrogant
تِحَرَّش	V	provoke
دَخلَة	N	entry
زَلّ	V	err
هَفوَة	N	lapse
اَثَر	N	trace
عِقال	N	headband
تَحاشَى	V	beware
قَضَى	V	decree
لَعَن	V	damn
تَنَقَّل	V	be_transferred
تِفَحَّص	V	examine
تَنبِيه	N	alarm
طَبَع	V	impress
بَوسَة	N	kiss
هَمَس	V	whisper
فَضَّل	V	prefer
تابَع	V	continue
بِلَيا	N	without
حِجاب	N	veil
عُمُوم	N	in_general
بَلَّغ	V	be_informed
شَهَد	V	witness
صِحَّة	N	health
حَساسِيَّة	N	allergy
زايِد	ADJ	make_exceeding
اِغتَصَب	V	rape
مُقلَة	N	eyeball
نَزَف	V	bleed
تَفَرَّق	V	split
رَحِيل	N	demise
اِحتَرَق	V	be_burned
دَم	N	dye
مَرِير	ADJ	stubborn
اِستَعَر	V	burn
وَداع	N	farewell!
صامِت	ADJ	silent
بَكَى	V	cry
كَبِد	N	liver
خَفَق-ُِ	V	tremble
تَدَفَّق	V	burst_out
عَبرَة	N	tear
اَقسَى	V	harden
نَوَى	N	distance
تَصَبَّر	V	be_patient
قَطِيعَة	N	rift
وِسع	N	capability
مُفتَرِق	ADJ	separated
تَأَثُّر	N	state_of_being_affected
اِفتَرَق	V	split
يَدّ	N	dor_handle
مَأساة	N	tragedy
مِخَلِّي	ADJ	making
خَطَف	V	pass_quickly
بَرَى	V	be_recovered
خاصَّة	N	features
غاضِب	ADJ	enraged
باكِي	ADJ	crying
مُؤلِم	ADJ	painful
اِختَرَق	V	traverse
شَيَّد	V	build
شَوكَة	N	prick
نَما	V	grow
اَنزَف	V	bleed
فُؤاد	N	mind
وُصُول	N	achieving
طَيّارَة	N	airoplane
داخِلِيّ	ADJ	domestic
اَبعَد	V	oust
صَرَخ	V	scream
اُمنِيَّة	N	wish
وَهلَة	N	moment
ساب	V	leave
مُعاناة	N	hardship
يَتِيم	ADJ	unique
مَقطُوع	ADJ	severed
طِفل	N	girl
لِعبَة	N	game
تِمثال	N	statues
ساكِن	ADJ	residing
مَرء	N	person
اَدرَك	V	reach
رِيح	N	odor
اِشتَهَى	V	desire
سَفِينَة	N	vessel
حَرَّك	V	energetic
شَرات	N	like
غَصَب	V	rape
عَصَر	V	squeeze
اِلتِقَى	V	meet
حَلَّق	V	encircle
سَبِيل	N	road
تَراجُع	N	retraction
حِقد	N	resentment
شُعُور	N	sentiment
حاقِد	ADJ	spiteful
حِرمان	N	deprivation
دَلاغ	N	sock
كَرامَة	N	generosity
كَعب	N	node
صابِب	ADJ	pouring
مُراسِل	N	correspondent
قِطاع	N	strip_(gaza)
جُزئِي	ADJ	particle
راتِب	N	pay
تَعَدَّى	V	overstep
مَسؤُول	ADJ	responsible
تَسَلَّف	V	borrow
حِينَة	N	times
وَصِيّ	N	trustee
راضِي	ADJ	consenting
قانُونِيّ	ADJ	law-related
اِفتَهَم	V	understand
ضَيَّع	V	lose
راغ	V	expel
مَجبُور	ADJ	compelled
مَصرُوف	N	expenditure
جُرثُوم	N	germ
مُعزِم	N	be_intend
مُنتَهِي	ADJ	expired
اِتَّجَه	V	be_directed
دُرج	N	desk_drawer
كَوي	N	ironing
اِلتَقَط	V	obtain
فَردَة	N	one_of_pair
مَقصُوص	ADJ	snipped
اَطلَق	V	release
سَراح	N	dismissal
حِصار	N	blockade
رَصّ	V	join_together
يَسار	ADJ	left
جَسَّم	V	materialize
جَوتِي	N	shoes
قاصّ	ADJ	snipping
مِنقَصّ	ADJ	snipped
طُفُولِي	ADJ	infantile
شَهقَة	N	sigh
مَكبُوت	ADJ	subdued
هَزّ	N	rocking
نَفي	N	rejection
سَبَّب	V	cause
غَيظ	N	wrath
تِعَوَّر	V	be_injured
وَرَّى	V	make_see
تَخَرَّع	V	be_irritated
ذاق	V	taste
عايَر	V	reprove
دَسَّ	V	conceal
مَأساوِيّ	ADJ	tragic
مُتَقَلِّب	ADJ	wavering
نَعِيم	N	happiness
نَفَث-ُِ	V	exhale
دُخّان	N	smoking
اِنتِقال	N	transfer
تِبَطَّل	V	begin
مُنزَوِي	ADJ	obscure
رَجَف	V	tremble
ضَمّ	V	combine
مُتَقَطِّع	ADJ	disrupted
بُكا	N	crying
مِفتاح	N	key
تَغَدَّى	V	take_lunch
خِلاف	N	dispute
طَيش	N	inconstancy
ضَيِّق	ADJ	restricted
اِضاءَة	N	illumination
مُتَدَلِّي	ADJ	dangling
اِتعَوَّر	V	be_wounded
مُستَمِرّ	ADJ	continuous
سَدَّد	V	hit
رَفسَة	N	kick
قَرصَة	N	pinch
تَوَجُّع	N	pain
رَغبَة	N	wish
مُلِحّ	ADJ	pressing
حاجَة	N	belonging
تَوالِي	N	continuous_succession
ذُروَة	N	peak
شَقّ	V	open_widely
كَحّ	V	cough
مُتَحَدِّث	N	spokesman
مُختَبِئ	ADJ	hidden
اَسفَل	N	under
مَكتَب	N	bureau
نَقَل	V	transfer
اَبيَض	ADJ	white
ناقَز	V	jump
فَأر	N	mouse
اِنقَلَب	V	turn_into
مَكتُوم	ADJ	hidden
عَلا	V	loom
اِمتَدّ	V	extend
رَشِيق	ADJ	slender
مُزَيَّن	ADJ	adorned
مانِكِير	N	manicure
هادِئ	ADJ	calm
كَشَّة	N	lock_of_hair
تَمَوُّج	N	oscillation
ضاحِك	ADJ	laughing
كَتَم	V	conceal
قَبضَة	N	grip
قُوِي	ADJ	strong
اِنمَدّ	V	be_spread_out
اَطيَب	ADJ	better
طِيب	N	noble
اَصفَى	ADJ	unblocked
صَفاء	N	clarity
اِنتَشَل	V	recover
بِقعَة	N	spot
مُلَوَّث	ADJ	polluted
فَقر	N	poverty
اُسطُورَة	N	tale
عِشق	N	love
غَلَط	N	error
تِسَبَّب	V	result_(in)
طَرد	N	dismissal
عِقِب	N	consequence
جَيش	N	army
دَورَة	N	period
مِصَعَّب	ADJ	nervous
طَرَد	V	expel
مِستَهتِر	ADJ	reckless
اِستَغفَر	V	ask_god_for_forgiveness
شَرط	N	condition
ضِيقَة	N	tightness
تَساؤُل	N	question
سكارف	N	scarf
صَلاة	N	salat
سَرِيع	ADJ	quick
تَركِيز	N	installation
خُشُوع	N	submissiveness
فَصَّخ	V	strip
اِسكارف	N	scarf
حِذال	N	side
قَلَم	N	pen
اِختَلَف	V	disagree
اِنقال	V	say
تَكبِير	N	amplification
مُؤَشِّر	N	indicator
نَبَّه	V	warn
خَطَأ	N	mistake
اِسلام	N	islam
حِرص	N	out_of_concern_for
تَوالَى	V	follow_in_succession
زِيارَة	N	visit
اِنتِهاء	N	finishing
عَيَّن	V	appoint
مَنصِب	N	post
مُمتاز	ADJ	privileged
اِستَقَرّ	V	settle_down
تَبِع	V	pursue
ثانِيَة	N	seconds_(time_span)
مُرِيح	ADJ	soothing
اَحاط	V	encircle
سِلسِلَة	N	chain
عَمِيق	ADJ	profound
مُقلِق	ADJ	disturbing
هُدُوء	N	silence
صُداع	N	migraine
نِصف	N	half
اَسفَل	ADJ	lowest
عَظمَة	N	piece_of_bone
رَقَبَة	N	slaves
خانِق	ADJ	suffocating
تَمَكَّن	V	be_able_to
وَدَّع	V	let_go
صَيفِيّ	ADJ	estival
تَطَوُّر	N	development
واضِح	ADJ	visible
شاشَة	N	screen
عِملاق	ADJ	super
لافِتَة	N	billboard
بِنايَة	N	building
حَوطَة	N	wall
فِيلّا	N	villa
مَدِينَة	N	city
اَخضَر	ADJ	green
مُشَبَّع	ADJ	saturated
زَفرَة	N	sigh
تَرَجَّع	V	reverberate
اِرتَفَع	V	ascend
صَرخَة	N	scream
راجِف	ADJ	tremulous
دَفَن	V	hide
طَيَّح	V	cause_to_be_lost
مَدخَل	N	entrances
فِلَّة	N	villa
اِستِغراب	N	surprise
دِروازَة	N	entrance
تَبَطَّل	V	be_opened
بِشكار	N	servant
يُونِيفَورم	N	uniform
زَهرِي	ADJ	pink
سَيطَر	V	seize
دَوا	N	medicine
حَول	N	concerning
نَحِيس	ADJ	ill-fated
زَفَر	V	exhale
رَدّ	N	reply
تِخَطَّى	V	get_past
ضَيم	N	injustice
بارِز	ADJ	prominent
وَلَد	V	give_birth_to
حُرقَة	N	burning
مَمَرّ	N	corridor
صَعَد	V	rise
لَفّ	V	attract
دَقَّق	V	be_precise
عِبارَة	N	expression
دائِرَة	N	ring
عَجُوز	ADJ	old_women
مِخَوَّر	N	cloak
نَقشَة	N	inscription
بَنَفسَجِي	ADJ	violet
شايِب	ADJ	gray-haired
اِنعَمَى	V	be_blind
كَندُورَة	N	gandoura
خَفَّض	V	reduce
اِشمِئزاز	N	repugnance
مَخلُوق	N	creature
تَمتَمَة	N	babble
مُنصَبّ	ADJ	devoted
زَهَّب	V	prepare
اِنرَسَم	V	be_drawn
حارِق	ADJ	burning
ثِقَل	N	load
خَلف	N	behind
اِشارَة	N	traffic_light
خَطَّى	V	be_exceeded
مَصدَر	N	sources
صَعقَة	N	lightning
مَسرَحِيَّة	N	plays_(theater)
حَنُون	ADJ	affectionate
مَسَحَ	V	trace
فُراق	N	separation
مِشوار	N	promenade
مال	N	capital
رُكبَة	N	knee
تَأَمُّل	N	speculation
مَشّ	V	wipe_off
وَسَّع	V	expand
طَوع	N	obedience
كَسَر	V	break
نَشَد	V	gravitate
بَأس	N	bad
اِنمَحَى	V	be_deleted
زَود	ADJ	a_lot
دَهشَة	N	surprise
تِجَنَّب	V	avoid
اَنَّب	V	scold
ضَرّ	V	harm
ظَنّ	V	think
مُعارِض	ADJ	opposing
مُتَقَبِّل	ADJ	accepting
طِيبَة	N	good_nature
حِيرَة	N	confusion
قَلَب	V	be_delighted
اُنثَوِيّ	ADJ	feminine
اِعتَفَس	V	lour
رَشّ	V	spray
صَحَّى	V	make_regain_consciousness
سُبات	N	slumber
لَهفَة	N	yearning
سُكَّر	N	sugar
صاب	V	hit
اِحتِمال	N	scenario
زار	V	visit
مِطَلَّق	ADJ	divorcing
اَحَبّ	V	love
صَمَت	V	be_silent
لَمَع	V	glitter
اَكَّد	V	affirm
اَرجَح	ADJ	most_probably
رَجفَة	N	tremor
مُرتَعِش	ADJ	quivering
لاشُعُورِيّ	ADJ	unconscious
ضاق	V	be_confined
مَأساوِيَّة	N	tragicness
دافَع	V	defend
اِنشَقّ	V	split_off
مُستَقِرّ	ADJ	at_ease
قَبر	N	sepulcher
غَرِق	V	sink
دِقَّة	N	precision
شامَة	N	mole
مِحَلِّي	ADJ	make_beautiful
مُتَوَقِّع	ADJ	expecting
خَيبَة	N	disappointment
مُحَيّا	N	facial_expressions
خاز	V	be_far_away_(from)
تَوأَم	N	twin
فاجَأ	V	surprise
تَفارَق	V	break_up_(from_each_other)
عَجَب	N	admiration
تَحَدِّي	N	challenges
مُعَلَّق	ADJ	be_hanged
مُمتَلَك	N	dependency
كَوبِي	N	copy
بَيست	V	paste
شِفَّة	N	lip
تَدوِيرَة	N	roundness
لَمحَة	N	glimpse
تِوَسَّع	V	expand
شَكا	V	suffer
عَذاب	N	pain
حَكَى	V	relate
اَه	N	sigh
دَفا	N	heat
حامِل	ADJ	pregnant
مَبرُوك	N	congratulation
سَهَّل	V	make_easy
اِستَنزَف	V	exhaust
طاقَة	N	power
ضَرب	N	striking
لِحاف	N	cover
فَون	N	phone
جَدوَى	N	advantage
تَواجُد	N	presence
حَدَر	V	run
تِرَيَّق	V	have_breakfast
غَطا	N	cover
جَزَى	V	reward
حَسّ	N	voice
فاء	V	wake_up
اُستاذ	N	professor
اُفّ	N	ugh!
تِغَسَّل	V	bathe
اِتوَضّا	V	perform_ablutions
فَرض	N	imposing
مِزَهِّب	ADJ	preparing
سَماوِيّ	ADJ	celestial
مِنَقَّش	ADJ	sculptured
رَمادِيّ	ADJ	ashen
فَوشيَه	N	fuchsia
مَوف	ADJ	purple
نِسبِيّ	ADJ	relatively
رَمادِي	ADJ	ashen
مُخالِف	ADJ	divergent
تَعَطَّر	V	be_perfumed
اِستَنَّى	V	wait
اَل	V	say
وَجبَة	N	meal
مُحَدَّد	ADJ	set
فُطُور	N	breakfast
رَأس	N	head
سائِد	ADJ	prevailing
مُزَهَّب	ADJ	prepared
زَقَر	V	call
صَحن	N	concave_mirror
بَيض	N	egg
مَسلُوق	ADJ	cooked
مَقلِي	ADJ	fried
جُبنَة	N	cheeses
زَيتُون	N	olives
خِيار	N	selection
طَماطِم	N	tomato
قُرص	N	tablet
خَبِيصَة	N	kind_of_food
بِثِيث	N	kind_of_food
حَلِيب	N	milk
صَمُّون	N	kind_of_bread
خُبز	N	bread
كُرواسُون	N	croissant
شَوكلِت	N	chocolate
ناظَر	V	search
رِيُوق	N	breaking_of_the_ramadan_fast
ناسَب	V	fit
شُكر	N	thankfulness
تِحَسَّب	V	think
بِنَيَّة	N	girl
بَعَّد	V	make_distant
رَدَّة	N	repulsion
طَفَّش	V	repel
اِتدَخَّل	V	be_plunged
تَسانَد	V	lean
عَصا	N	baton
اِنتِصار	N	victory
سَندوَيتش	N	sandwich
هَوت	ADJ	hot
اِتمَشَّى	V	go
سَبَق	V	precede
تَجَرَّد	V	be_stripped
تَكَبَّر	V	be_haughty
ظالِم	ADJ	oppressive
شايِل	ADJ	carrying
اِتصَرَّف	V	behave
حامَى	V	defend
شُوَيّ	N	few
تِفاجَأ	V	surprise
ذُكُورِيّ	ADJ	male
بَحَّة	N	hoarseness
عَصُّوب	ADJ	nervous
عالَمِيّ	ADJ	world-wide
مِغَربِل	ADJ	sifting
تَغَربِيل	N	screening
حَشَر	V	upset
زاوِيَة	N	corner
تِشَكَّى	V	complain
عَداوَة	N	antagonism
قِيامَة	N	resurrection
سَيرَة	N	course
مِغَبَّر	ADJ	dusty
جَرّ	V	pull
اِنتَفَض	V	shake
قَبضَنِيَّة	N	contraction
سانِد	ADJ	standing
مِغَمِّض	ADJ	closing_eye
اِختَنَق	V	be_constricted
حاصَر	V	blockade
مَلا	V	fill_out
ذُعر	N	fright
اَتفَه	ADJ	more
حاوَط	V	go_around
يَوَّد	V	seize
مُختَنِق	ADJ	strangled
تَكَرَّر	V	give_back
مُزعِج	ADJ	annoying
مُتَّصِل	ADJ	connected
خارِجِي	ADJ	external
اِنفَجَر	V	explode
خَرَّع	V	shock
دَوخَة	N	vertigo
مُوَصِّي	ADJ	recommending
اَهمَل	V	forget
طَبّاخ	N	cook
اَخَّر	V	be_far_away_(from)
مُهِمّ	N	main_thing
مُحامِي	N	defense_counsel
اِحصائِيَّة	N	calculation
فات	V	go_by
راجَع	V	see_our
داعَة	N	sponsorship
اَذَّن	V	call_prayer
بَنَدُول	N	panadol
اِسَّبَّح	V	take_a_shower
تَخَربَط	V	confused
ضَغط	N	stress
مِتكَسَّر	ADJ	broken
عَضَلَة	N	muscles
اِرتَخَى	V	be_slackened
حارّ	ADJ	fervent
دُش	N	shower
شِوَيَّة	N	a_little_bit
سُبُوح	N	swimming
جامَة	N	glass
اِنعِكاس	N	reflection
مَرَّر	V	go_through
وارِم	ADJ	swollen
مِتشَقَّق	ADJ	fissured
يَمِين	ADJ	right_side
خُرُوج	N	getting_out
مَسافَة	N	distance
نَبَّش	V	search
عَلاج	N	treatment
فَوضَى	N	chaos
بَوكّ	N	purse, wallet
كِلَينِكس	N	napkin
مِيكاب	N	makeup
اِستَخدَم	V	employ
زِيادَة	N	more
عِلبَة	N	navel
شَمسِيّ	ADJ	solar
بِدّ	N	desire
طَوَل	V	lengthen
تَصادُم	N	collision
ضَربَة	N	strikes
حَدِيدَة	N	iron
فَرَك	V	rub
مادّ	ADJ	providing
طَيَران	N	flying
كاب	N	cap
صَدَم	V	shock
كَرِيه	ADJ	repulsive
فاتِح	N	light
اِتحَسَّب	V	think
اَجنَبِي	ADJ	foreign
حَبَّة	N	some
كِتِير	ADJ	a_lot
رَوب	N	dressing_gown
نَشَّف	V	make_dry
دافِي	ADJ	warm
شِتا	N	winter
بَرد	N	cooling
يَبَّس	V	make_dry
اَقرَب	ADJ	most_likely
ساق	N	leg
مِخَطَّط	ADJ	lined
اِسوِد	N	black
لَيجَينز	N	legging
سَمِيك	ADJ	oppressive
اَذان	N	call_to_prayer
اِقامَة	N	residency
فَردِي	ADJ	individual
اِتيَدَّد	V	wash_(before_prayer)
سَشوَر	V	to_dry_hair
طَبِيعَة	N	nature
كَيرلِي	N	curly
جَعَّد	V	make_curly
مُجَعَّد	N	curled
لِيفَة	N	fiber
اِستَشوَر	V	make_hair_extensions
شال	N	fulling
سِلِبَر	N	slipper
نَفسِيَّة	N	psychology
عال	ADJ	OK
تَخَبَّر	V	inquire
سَما	N	sky
زِراعَة	N	agriculture
خَشَب	N	wood
نافُورَة	N	fountain
مِبَطَّل	ADJ	open
رَهِيب	ADJ	dreadful
لَيزِك	N	lasik
تَناثَر	V	be_dispersed
رُبع	N	quarter
شَمس	N	sun
اَشرَق	V	rise
شُرُوق	N	sunrise
مُشرِق	ADJ	shining
مُتَدَرِّج	ADJ	gradual
مُحاصِر	ADJ	surrounding
تَمتَمَ	V	mutter
مَسك	N	holding
فارق	V	depart_from
ظِلّ	N	shelter
اَجل	N	because_of
مَنبَع	N	spring
تَصدِيق	N	belief
نَسِي	V	forget
دَهَن	V	varnish
كِرِيم	N	cream
مِخَربَط	ADJ	confused
عَمِل	V	how_make
ظَلّ	V	remain
تَرَف	N	wealth
سَبَّح	V	make_swim
سَحَّى	V	comb
مِدَلِّع	ADJ	spoiling
عامَل	V	treat
هَلّ	V	appear
مُتَحَمِّل	ADJ	assuming
كُوب	N	searchlight
تِكَسَّر	V	be_broken
مُتَفاجِئ	ADJ	surprised
عِزَّة	N	honor
تَسرِيحَة	N	coiffure
تَقَبُّل	N	acceptance
تَجرِيح	N	slander
حَلِيل	N	husband
حَبَّة	N	seed
غَمَر	V	immerse
اِنكَسَر	V	be_broken
حِذا	N	ahead
نَدبَة	N	incision
اِنضَرَب	V	be_strike
بادَل	V	trade
دُكتَور	N	doctor
راسِب	N	remnant
اِستَحلَم	V	dream
لاصِق	ADJ	attached
باقِي	N	remainder
اِنسَمَع	V	be_heard
جِدِّيَّة	N	earnestness
كاتِم	ADJ	silencer
تَلَوَّم	V	be_slow
هَمس	N	muttering
اِيجاب	N	compliance
شَهَق	V	bray
اِستَكثَر	V	increase
دَين	N	debt
كَتمَة	N	concealment
سُكُون	N	rest
تِمَلَّك	V	possess
اِنقَبَض	V	be_arrested
اِتعَرَّف	V	identify
اِستَدرَج	V	promote
شال	ADJ	lifting
راديٌو	N	radio
مَحَطَّة	N	stop
تَسَمَّع	V	listen
اِذاعَة	N	radio
ثَنَى	V	fold
وَنَّس	V	keep_company_with
غَثّ	V	annoy
مِشط	N	comb
طَمَأنِينَة	N	calm
تَعالَج	V	undergo_treatment
شَفَى	V	recover
هَرَم	ADJ	senile
جَوَّز	V	marry_off
مِبَهدِل	ADJ	degrading
اِصطَلَب	V	be_educated
تَوَخَّر	V	be_late
راكَض	V	race
اَشقَر	ADJ	blond
اِنشَدّ	V	pull
جَنب	N	side
قَسَّم	V	partition
قِسمَة	N	division
عَقصَة	N	group_of_hair
اَزيَن	ADJ	better
لَوَّن	V	colorize
صَبَغ	V	dye
غَلِيظ	ADJ	viscous
فَخذ	N	subdivision
كَلَّف	V	charge
اِنسَدَح	V	sleep
مُعَوِّذَة	N	quran_verses
غَفَى	V	doze_off
وَضع	N	condition
شَدَّ	V	make_strong
هَمسَة	N	whisper
تَغَلَّى	V	prim
عَيارَة	N	deception
وَدّ	V	love
بَقَر	N	cow
حَفِيد	N	grandson
اُسطُوانَة	N	disk
غِبنَة	N	fraud
مَرحُوم	ADJ	deceased
غَلا	N	precious
اِهتَزّ	V	tremble
دَفش	ADJ	rude
عَوار	N	pain
دَغدَغ	V	tickle
بَلاش	N	free
كِدَه	N	like_that
كُوَيِّس	ADJ	beautiful
فَطِن	ADJ	clever
وِشّ	N	face
اَطَّع	V	cut
خَيزَرانَة	N	baton
اِحراج	N	embarrassing
لِعب	N	playing
عِزبَة	N	country_estates
اَقبَل	V	engage_in
بُنَيَّة	N	little_daughter
مَفرُوض	ADJ	imposed
صَخّ	V	be_aware
بِلاي	N	play
سِتَيشَن	N	station
حَماس	N	enthusiasm
كُرَة	N	ball
اِمتَلَك	V	own
مَشكُور	ADJ	praiseworthy
عَقِيم	ADJ	unproductive
دانَى	V	be_near
تَحَسَّر	V	regret
عَسَل	N	honey
فَلَع	V	make_split
شات	V	kick
زاعَق	V	shriek
كِذا	N	like_this
فِيلَّا	N	vella
مُقابَلَة	N	opposite
لاب	N	laptop
حَشّ	N	censure
خَلق	N	creatures
صُغَيُّور	ADJ	small
تِسَلَّى	V	entertain
مِحتِشِر	ADJ	terrified
طَنازَة	N	ridicule
مُخَبَّل	ADJ	confused
ماما	N	mama
عَنقُود	N	cluster
خاب	V	be_frustrated
ظَنّ	N	assumption
مَولُود	ADJ	born_in
قِبلِي	ADJ	southern
صادِق	ADJ	veracious
فَرِيق	N	faction
قِير	N	gear_shift
مال	V	lean
مَزح	N	joking
كُوشِيَّة	N	pillow
مَرَّغ	V	roll_in_the_dust
اِصطَلَح	V	be_repaired
عِبرَة	N	admonition
فُو	N	mouth
عاشَر	V	associate_with
مُعاشِر	ADJ	having_contact_with
اِستِهبال	N	foolness
راضَى	V	conciliate
مُخّ	N	mind
بات	V	remain
شِلَّة	N	clique
اِعتَمَد	V	depend
طَبَّق	V	apply
شَرع	N	religious_law
مِحَلِّل	ADJ	allowing
نافَخ	V	be_out_of_breath
حَمَد	V	extol
اِستَلَم	V	receive
ماخِذ	ADJ	taking
مُتَوَلِّع	ADJ	passionate
اِحتَشَر	V	jangle
غَلَب	V	defeat
دَفَع	V	motivate
كَسَب	V	obtain
مُعدِي	ADJ	infectious
اَصاب	V	be_hit
غَداء	N	lunch
قَرار	N	decision
هِستَيريا	N	hysteria
بَلِيَّة	N	tribulation
سَنَد	V	lean
عَمَل	V	do
مِضايِق	ADJ	disturbing
اِطَّمَّن	V	be_reassured
اِجتِماع	N	meeting
داعِي	N	reason
لازَم	V	accompany
حاضِر	N	audience
قانُون	N	law
صَنف	N	types
بِريانِي	N	biryani
دَجاج	N	hen
سَمَك	N	fish
مَشوِي	ADJ	roasted
وَرَق	N	waraq
عِنَب	N	grapes
بَشامَيل	N	kind_of_pasta
سَلَطَة	N	salad
اَكلَة	N	meal
جَوعان	ADJ	hungry
باستا	N	pasta
مَشرُوم	N	mushroom
اِيطالِيّ	ADJ	italian
ذُرَة	N	sorghum
فِطر	N	fungus
شُوربَة	N	soup
ثانك	N	thank
عافِيَة	N	good_health
شَهِيَّة	N	appetite
مَحرُوم	ADJ	deprived
ثُلُث	N	one_third
تَغَيَّب	V	be_absent
مِخباة	N	sine
خَبَر	V	reach
مُتَصَدِّر	ADJ	heading
اِستِكان	N	glass
عَذَر	V	excuse
جَهُورِيّ	ADJ	loud
باشَر	V	undertake
رِزق	N	livelihood
مِليُونَير	N	millionaire
صاحِب	ADJ	owner
عَقار	N	immovable_property
اِستِخفاف	N	facilitation
واحِد	ADJ	one
سَرَق	V	rob
رِيال	N	riyal_(s.ar.=100_halala
نَبَذ	V	discard
تَأَقلَم	V	adjust
حَجَرَة	N	a_stone
عَثرَة	N	stumble
تِجَرَّأ	V	have_the_face_to
مُقَلِّل	ADJ	reducing
اِحتِرام	N	respect
حاسَب	V	settle_a_mutual_account
اِنوَخَذ	V	be_taken
ظُلم	N	injustice
شال	V	delete
شارِد	ADJ	tramp
هاب	V	respect
فَهد	N	leopard
اَسَد	N	lion
عَشا	N	dinner
تَصمِيم	N	design
مُهَندِس	N	technician
شَوَر	N	shower
مِظَهَّر	ADJ	preparing
تِيشِيرت	N	t-shirt
جاكِيت	N	jacket
كَعكَة	N	cake
واقِي	ADJ	guarding
جِلَوس	N	gloss
مَلَفّ	N	dossier
صِينِيَّة	N	a_large_metal
جاهِز	ADJ	equipped
عَجَلَة	N	wheel
اِنضِباط	N	precision
قَلِيل	ADJ	small
باي	N	bye
ظُهر	N	afternoon
عابَل	V	continue
راديُو	N	radio
صَبَّح	V	greet
تِوَكَّل	V	entrust
مُدِير	N	manager
هَذَّب	V	prune
طابُور	N	line
حِصَّة	N	period
قَدّ	N	amount
مَرسِيدِس	N	mercedes
رَشا	V	bribe
اِتِّفاق	N	agreement
تَوصِيلَة	N	conveyance
مَطلُوب	ADJ	necessary
وَقَع	V	be_located
حَسَن	N	all_right
حُبُور	N	joy
مُباراة	N	game
خُاف	V	fear
ساد	V	govern
مِرَحَّب	ADJ	receiving
جُملَة	N	sentence
مُعلِن	ADJ	anN
حِوار	N	dialogue
فَضا	V	become_empty
اِلتِزام	N	obligation
خالَف	V	contradict
اِنهاء	N	termination
عَمَل	N	activity
مَوعِد	N	rendezvous
باقَة	N	bouquet
وَرد	N	rose
اِنغَرّ	V	be_lured
مَدِيح	N	acclaim
تَرحِيب	N	greeting
مُهتَزّ	ADJ	trembling
اُخُوَّة	N	brotherhood
شَوَّه	V	tarnish
تَقَصَّد	V	consider
اَثار	V	provoke
اِستَفَزّ	V	provoke
نَبذ	N	renunciation
ناكِر	ADJ	disavowing
مُلازِم	ADJ	accompanying
تِلاقَى	V	meet_each_other
دَور	N	role
سِكِرتِير	N	secretary
ذَوق	ADJ	attractive
لَمسَة	N	tinges
كلاسِيكِيّ	ADJ	classic
اِختِيار	N	selection
جِلد	N	skin
زُجاج	N	glass
قاعِدَة	N	basis
مَحكَمَة	N	court
قَضِيَّة	N	problem
سابِق	ADJ	preceding
تَوفِيق	N	success
سِكرِتِير	N	secretary
حِذاء	N	(pair_of)_shoes
مِكَحَّل	ADJ	painted_with_kohl
رَأَى	V	see
سِوَى	N	otthan
قادِم	ADJ	next
اِستَأنَف	V	resume
اَحضَر	V	bring
بَرِيد	N	mail
اَبلَغ	V	inform
اِدارِيّ	ADJ	management
قِسم	N	division
فَضاوَة	N	emptyness
مُقفَل	ADJ	blocked
لَدَى	N	with
سَيِّد	N	gentlement
مُؤَجِّل	ADJ	postponing
اِحتَكّ	V	deal
تَحَمحَم	V	snicker
قَطّارَة	N	dropper
تَعازَم	V	mutual_invite_(each_other)
كارد	N	card
قَريَة	N	village
شايِب	N	gray-haired
اُغمَى	V	lose_consciousness
فَصَل	V	separate
ضَغَط	V	stress
اِرادِي	ADJ	intentional
عائِلِيّ	ADJ	domestic
حَضَر	V	arrive
كَنسِل	V	cancel
اِزداد	V	increase
شِبرِيَّة	N	bed
اَكِيد	N	sure
تايِه	ADJ	lost
غَرَّق	V	inundate
عَرَق	N	araq_(ouzo)
تَصَبَّب	V	perspire
جَبِين	N	brow
شَوك	N	thron
غَزّ	V	knife
مُتَمَرِّد	ADJ	rebel
حَقِير	ADJ	despised
خَبِيث	ADJ	malicious
اَقصَى	ADJ	farthest
رِضاع	N	breast_feeding
ذِراع	N	crank
مُطِيع	ADJ	disciplined
لَدُود	ADJ	implacable
ماكِر	ADJ	cunning
دِرع	N	armor
مُواجَهَة	N	encountering
اَقوَى	ADJ	most_powerful
حَرارَة	N	heat
مُظلِم	ADJ	dark
مُلُوحَة	N	saltiness
طَوَى	V	fold
دافِن	ADJ	burying
وَسِيع	ADJ	wide
مِجَرَّب	ADJ	attempting
تَمتَم	V	mutter
عانَى	V	suffer
اَنِين	N	moaning
رَحَل	V	move_away
تَأَوَّه	V	sigh
اِستَنَد	V	lean
لَحَف	V	cover
مُحتَضِن	ADJ	embracing
جَبهَة	N	front_line
جَناح	N	suite
اَنهَى	V	be_completed
وَسِيط	N	go-between
وَقفَة	N	posture
حَلال	ADJ	permissible
حَرام	ADJ	prohibited
مَنقُود	ADJ	criticized
اَساس	N	basically
تَربِيَة	N	education
صاع	V	loaf_about
خَوي	N	brother
مِعَقَّد	ADJ	intricate
حَيَّر	V	confuse
شَبَه	N	resemblance
اَوسَم	ADJ	more_beautiful
سَيف	N	sword
سِنَّة	N	tooth
مَرصُوص	ADJ	compacted
سُفلِيّ	ADJ	lower
عِلوِي	ADJ	superior
مَرسُوم	ADJ	sketched
رَشَّة	N	drizzle
مَحا	V	wipe_out
مُخَيِّلَة	N	mind
مُجَرَّد	N	for_the_sole_reason_that
حام	V	hover
لَطَّخ	V	soil
قَذارَة	N	filth
اَزعَج	V	bother
اِشمَأَزّ	V	be_nauseated
مِتجَمِّع	ADJ	gathered
نَفَخ	V	inflate
اِتَّقَى	V	beware
حَلِيم	ADJ	patient
غَضَب	V	become_angry
راصّ	ADJ	pressing
بَدال	N	instead_of
شَور	N	consultation
فَرَق	V	differentiate
مالّ	ADJ	become_impatient_with
اِذلال	N	degradation
تَكَرَّم	V	be_gracious
مُحتَقِر	ADJ	despising
تَحَكَّم	V	control
مَثَّل	V	act
مِخَبَّر	ADJ	telling
نَغَز	V	prickle
دايِخ	ADJ	conquering
بِشكارَة	N	servant
خَبَّص	V	mix
بَخَّر	V	burn_incense
مِظَهِّر	ADJ	bringing_out
فِلات	ADJ	flat
شُوز	N	shoes
بَشَّر	V	bode
مِنِيح	ADJ	good
طَمَّن	V	calm_down
مِبخَرَة	N	censer
سِكَينِي	ADJ	skinny
ذَهَبِي	ADJ	gilded
بَدِي	N	body
اَخضَر	N	green
جاكِت	N	jacket
مِسَكِّر	ADJ	closed
سَير	N	sir
اِسعاف	N	medical_service
مَرفُوع	ADJ	raised
ذَيل	N	tail
حُصان	N	horse
مُجَعَّد	ADJ	curled
قَشعَرِيرَة	N	trembling
تَزَهَّب	V	to_be_ready
مُرَطِّب	ADJ	moisturizer
مُختَلَف	ADJ	various
جِنسِيَّة	N	nationality
مُجتَمِع	ADJ	assembling
عَرَبِيّ	ADJ	arabic
اَعجَمِيّ	ADJ	non-arab
اَفرِيقِيّ	ADJ	african
اَسيَوِيّ	ADJ	asian
اَمرِيكِيّ	ADJ	american
اُورُبِّيّ	ADJ	european
فَقِير	ADJ	poor
غَنِيّ	ADJ	wealthy
دِيانَة	N	creed
مَرحَلَة	N	phase
عَرَض	N	symptom
كُحَّة	N	cough
تَوَقُّف	N	halt
صُعُوبَة	N	difficulty
فَحص	N	examination
عَمَلِيَّة	N	mission
اِستَأصَل	V	uproot
اِكتَشَف	V	discover
تَطَوَّر	V	develop
شِفا	N	remedy
اَنّ	V	complain
واقِع	N	actual
هَزَّة	N	tremor
مِستَوِي	ADJ	taking_place
اَخطَر	ADJ	most_serious
مِيَوِّد	ADJ	withholding
لَوعَة	N	anguish
دَوَّخ	V	molest
دَبَّة	N	bottle
رَنَّة	N	ringing
رَجَّع	V	send_back
تِمَشَّى	V	walking_with
تَعبِير	N	expression
اِزعاج	N	disturbance
مِسَيطِر	ADJ	ruling
مِغَرَّق	ADJ	inundating
مَلائِكِيّ	ADJ	angelical
مُغرَق	ADJ	engrossed
سَدَّ	V	plug
اِتِّجاه	N	toward
سَخافَة	N	folly
عِقد	N	necklace
تارِيخ	N	date
مِيلاد	N	birthday
فَصِيلَة	N	category
قِلادَة	N	necklace
مَعلُومَة	N	datum
اِختَضّ	V	be_agitated
عَبَط	N	folishness
طَبلَة	N	drum
رَضِيع	ADJ	foster_child
صَون	N	preservation
حاشِر	ADJ	disturbing
تَناقَر	V	quarrel
نِقاب	N	veil
وَصف	N	considering
جُمهُور	N	mass
عابِر	ADJ	traversing
عَفو	N	excuse_me!
مَعذُور	ADJ	excused
حِلّ	N	permission
وَشَك	N	on_the_verge_of
تِخَطرَف	V	flee
سَبَق-ُِ	V	precede
كَورس	N	course
بَسمَة	N	smile
اِحتَلّ	V	be_occupied
مُبَكِّر	ADJ	early
بُلعُوم	N	pharynx
خار	V	disgrace
جَيب	N	sine
سالِم	ADJ	intact
مُماثِل	ADJ	similar
اَردا	ADJ	worse
مَوجَة	N	waves
وَزن	N	weight
مَيَّز	V	differentiate
كَفّ	N	palm_of_the_hand
تِقَرَّب	V	approximate
رِيحَة	N	odor
اِعتَصَر	V	squeeze
شافَى	V	recover
اَعمَق	ADJ	deepest
نُقطَة	N	location
اِنفِعال	N	emotion
مَسار	N	path
سال	V	leak
لانِهايَة	N	infinity
مَفهُوم	ADJ	intelligible
اِنهِيار	N	breakdown
نَهَر	V	rebuff
مَزرَعَة	N	farm
مَسبَح	N	swimming_pool
بَوَّز	V	be_glum
لَبَّس	V	dress
جِلَس	V	sit
مِعَوِّذَة	N	quraan_verses
رِئَة	N	lung
عالَج	V	treat
كِيماوِيّ	ADJ	chemical
سَرَّح	V	prune
تَشَقَّق	V	be_split
عَرض	N	presentation
زال	V	cease
ضَعف	N	weakness
هَيبَة	N	respect
هَزِيل	ADJ	emaciated
ضَعَف	V	become_weak
وَجَع	N	pain
اَنَّة	N	sigh
اَلَم	V	pain
دَعوَة	N	call
شَجَّع	V	promote
دُعاء	N	call
اَجاب	V	comply
رَدَّد	V	reiterate
جُمعَة	N	meeting
صِندُوق	N	bin
وَجَب	V	be_necessary
حَدَث	V	happen
اَصبَح	V	become
بَقِيَّة	N	remnant
اِستَطاع	V	be_able
مُرُور	N	going_(through)
اِسوِداد	N	blackening
عَتمَة	N	darkness
خائِف	ADJ	afraid
نِسيان	N	forgetfulness
طَبِيب	N	doctor
رُبَّما	N	perhaps
مُستَقبَل	N	future
اَن	N	now
بُلُوغ	N	puberty
سَيِّء	ADJ	bad
سَحَّاب	N	zipper
مُوجَز	N	summary
صَباحِيّ	ADJ	matinee
هَلَّا	N	now
اِستِراحَة	N	rest
اَجَّل	V	delay
رَكَع	V	bow
نَثَر	V	scatter
صَلَّب	V	harden
حَسَّاس	ADJ	sensitive
كُحلِيّ	ADJ	aqua_blue
عَوَّد	V	accustom
مَصَحَّة	N	sanatorium
مَحطُوط	ADJ	be_put
تَجاهَل	V	ignore
مُرتَجِف	ADJ	tremulous
اِرتَشَف	V	sip
رَشفَة	N	gulp
بَلَّل	V	dampen
فاكِهَة	N	fruit
باغَم	V	shout
طَبَخ	V	cook
نِظِيف	ADJ	clean
مُشَكَّل	ADJ	diversified
مُتَواصِل	ADJ	connected
اِرتِطام	N	impact
خاشُوقَة	N	spoon
مَوز	N	banana
ظَلام	N	injustice
مِأَذِّن	ADJ	calling_for_praying
مَغرِب	N	sunset
تَمَسَّك	V	clutch
شَمّ	V	sniff
هَوا	N	atmosphere
ذَهَب	V	go
مَسجِد	N	mosque
تَشَرَّف	V	be_honored
عاجِل	ADJ	at_once
اَجِل	ADJ	deferred
تَعوِيض	N	restitution
حِفاظ	N	guarding
تَماسُك	N	cohesiveness
مُمتَدّ	ADJ	spreading
تَرابُط	N	cohesion
قَمع	N	repression
تَفرِقَة	N	separation
تَفَكُّك	N	disruption
عُنُوسَة	N	celibacy
مُرتَفِع	ADJ	loud
طَلاق	N	divorce
تَمَصخَرَ	V	deride
ضَيَّق	V	disturb
نَغزَة	N	riddles
داخ	V	be_nauseated
خَسران	ADJ	loser
مَرِض	V	become_ill
اِنتِحار	N	suicide
دَخَّن	V	smoke
نَحَر	V	slit_the_throat
صَلَب	V	crucify
شَرشَح	V	squawk
جَزاء	N	penalty
فَرح	N	joy
مَنزِل	N	houses
حِيل	N	very
مَرمُوق	ADJ	notable
حَشا	N	bowel
ضَحِيَّة	ADJ	victim
نَقل	N	quoting
ناقِل	N	conveying
ذِكر	N	memory
حِكايَة	N	account
تَجمِيع	N	joining
دَلُّوع	ADJ	spoilt
مُنتَدَى	N	conference
بارت	N	part
خَطَر	V	occur
حَضرَة	N	presence
كِذب	N	falsehood
تَحَرَّج	V	narrow
دِعمَة	N	prop
تِرَوَّع	V	be_frightened
اِهداء	N	leading
مِسَجِّل	ADJ	recorder
طايِِر	ADJ	meal
عَلَّى	V	raise
عِلَّة	N	defect
تِدَهوَّر	V	decline
اَدَّب	V	punish
دُوار	N	track
حِواطَة	N	walking
فاجّ	ADJ	oppening
مِنصِدِم	ADJ	shocked
سايَر	V	go_along_with
اِعتِبار	N	regard
مِوَقِّف	ADJ	detaining
شُوَيَّة	N	a_little_bit
اِرتَعَش	V	shake
مِصطِنِع	ADJ	synthetic
اَسرَع	ADJ	faster
وَخَّر	V	go_slow
نَرفَز	V	make_nervous
طُرطُور	N	trivial
حَمَق	N	stupidity
اِنطَرّ	V	crack
قَلَع	V	uproot
مِترَوِّع	ADJ	be_frightened
مَطّ	V	stretch
شِبه	N	similar
عُنف	N	force
خالِي	ADJ	free
حَدّـ	N	individual
طَيَّر	V	make_fly
مَفتُوح	ADJ	opened
بُكس	N	box
حِدَّة	N	intensity
اَشَدّ	ADJ	stronger
زَخّ	V	seize
ذَقن	N	chin
اَعلَى	ADJ	highest
حاجِز	ADJ	boocking
تَذكَرَة	N	ticket
صايِع	ADJ	tramp
مايِع	ADJ	swaying
عاطِي	ADJ	donor
حَيَوان	N	animal
حَجَز	V	retain
حَلِّي	V	be_adorned
راعِي	ADJ	sponsor
فَزعَة	N	help
شادّ	ADJ	tightening
اَخـ	N	brother
ناقِع	ADJ	exploding
مِحتِرِق	ADJ	be_burned
مِتفَيزِر	ADJ	frozen
عَيَّب	V	scoff_at
زِفت	N	asphalt
خايِس	ADJ	traitor
عواف	N	good_health
اِفتَكَر	V	think
بَرَّر	V	vindicate
ماسِج	N	messages
بُرص	N	gecko
قَرَف	N	loathing
اِندَرَى	V	know
خَفَّف	V	mitigate
مِشتَطّ	ADJ	flared_up
بَقَرَة	N	cow
تِصَيَّع	V	loaf_about
هانِم	N	lady
اِترَقَّص	V	move
تَرَقَّص	V	move
قُوطِي	ADJ	small-minded
تامّ	ADJ	continuing
مِسافَر	N	traveler
قايِِل	ADJ	person_who_says
خَلِيّ	V	leave
سَهَر	N	night_without_sleep
بِلِيستَيشَن	N	play_station
عَنز	N	goat
مُوَدِّي	ADJ	delivering
مَجال	N	area
وَحدَة	N	individual
قابِض	ADJ	withholding
تِأَسَّف	V	bring_down
حامِض	N	acid
قَبَض	V	seizure
عَدَّى	V	make_pass
واصَل	V	continue
اَخبَل	ADJ	insane
يَوَّل	V	dance_the_dance_the_yowla
فالِح	ADJ	fortunate
تِأَمَّر	V	come_to_power
نَجَح	V	succeed
وَطَّى	V	transfer
قَفَل	V	lock
مُبايِل	N	mobile
اَخّـ	N	little_brother
مَذهَب	N	path
قَفطَة	N	scandal
مَلَّك	V	write_wedding_contract
فَلَح	V	succeed
ناوِي	ADJ	intented
خَوَّن	V	consider_faithless
شَهادَة	N	witness
حَمَّال	N	carrier
مَسَّخ	V	be_ruined
حِمار	N	donkey
شَبَّه	V	compare
مَساخَة	N	the_action_to_be_bland
مِضارِب	ADJ	quarreling
عَباة	N	cloak
سُوِيق	N	car_key
عَزم	N	determination
قافِل	ADJ	closing
ثَوب	N	robe
صارِم	ADJ	rigorous
بَيَّض	V	blanch
بَكالُوريَوس	N	bachelor
واعِد	ADJ	promising
ناجِح	ADJ	winning
تَحِيَّة	N	greeting
فَيديَو	N	video
فَجّ	V	expand
هِستِيرِيَّة	N	hysteria
مِتزاعِل	ADJ	quarreling
نَكَّد	V	annoy
مِضّايَق	ADJ	annoyed
عَقَد	V	convene
فَنَّان	N	artist
لَوَى	V	be_bent
تِمَسخَر	V	make_fun
حَشِيمَة	ADJ	respectful
اَقلّ	ADJ	smallest
حُكم	N	judgment
مَلزُوم	ADJ	liable
نَصر	N	victory
تِباوَس	V	kiss
مَحظُوظ	ADJ	contented
عَجُوز	N	old_women
تِنَطَّح	V	butt
شَباب	N	youthfulness
مِتوَعِّد	ADJ	threatening
تِركَش	ADJ	turkish
بِرمَود	N	bermuda
كَتّ	N	cut
سادَة	ADJ	okay
قَبّاضَة	N	clip
فَلّ	V	break
حَزَّة	N	times
مِتلَصِّق	ADJ	attached
مِتفاجَأ	ADJ	surprised
مَرَة	N	wife
مِتعَمِّد	ADJ	intended
وَحشَة	N	desolation
غاطّ	ADJ	hidden
مِفتِشِل	ADJ	disgraced
فُوَّالَة	N	side_dish_with_coffee
مِتكَهرِب	ADJ	electrically_charged
مِساع	ADJ	able
خانُوم	N	lady
اِستَسمَح	V	ask_forgiveness
اِنجَرَح	V	be_wounded
مِكَبِّر	N	amplifying
اِنقَلَع	V	banish
حَلفَة	N	oath
طِراق	N	knocking
اَدَمِي	ADJ	humane
قِمَّة	N	top
قَسَم	N	oath
مِسكِين	ADJ	humble
عَرَج	V	be_lame
خَقَّة	N	innovation
يابِس	ADJ	dried_out
قايِم	ADJ	standing
نَذِل	ADJ	despicable
جَدّ	N	earnestness
اِتضَرَب	V	be_hit
لَصَق	V	paste
اِغتَرّ	V	be_misled
شارَك	V	participate_with
حَيا	N	modesty
عَيَّار	ADJ	impostor
صَمّ	V	stop_up
جَدار	N	wall
مِحلِّو	ADJ	be_sweeten
طَنَّز	V	make_fun
نِيَّة	N	desire
شِين	ADJ	bad
مِلاحِظ	ADJ	be_observe
عَفَوِيَّة	N	spontaneity
مَسأَلَة	N	issue
مِعتِمِد	ADJ	depending
حَوالِي	N	approximately
اِنوَلَد	V	be_born
بَردان	ADJ	cold
اَتدَفَّى	V	heat
غَفَر	V	forgive
حِكمَة	N	maxim
اَغرَى	V	induce
قارَن	V	compare
بَطَّى	V	delay
مِتراضِي	ADJ	mutual_consenting
قَهوَة	N	coffee
طَوَّف	V	raise
اِندَوَك	V	take,look, observe
مَندُوب	N	delegate
وَصَّل	V	accompany
دَلّ	V	pamper
مِتَعِّب	ADJ	disturbing
سِواقَة	N	driving
ناوِي	N	intended
نَشَب	V	pertain_to
جِدِّي	ADJ	serious
راعَى	V	be_observed
هُرن	N	gong
سَوَى	V	have_a_value
بَدَّى	V	be_superior
عَنسِلانَة	N	scincus
سِمّ	N	poison
سَمّ	V	poison
حَرَّة	N	wrath
جِنُونِي	ADJ	insane
بَرَد	V	be_refrigerated
طَشُونَة	N	a_little_bit
تَخرِيب	N	sabotage
شَخَط	V	shout
اَخبَل	ADJ	insane
شَجاعَة	N	courage
مِفتِكِر	ADJ	thought
فَزَّع	V	dismay
هازَب	V	ben
زَعطُوط	N	infant
ظَلَّم	V	be_darkened
بَطّ	V	torment
سَدّ	V	obstruct
مُنتَجَع	N	resort_(vacation_place)
ساع	N	hour
رَحمَن	ADJ	merciful
رَحِيم	ADJ	compassionate
سامِع	ADJ	listening
خايِس	N	dirty
تِراضَى	V	conciliate
لِعبان	N	playing
بَركَن	V	park
مَطلَب	N	request
فَضفَض	V	flutter
وِثَق	V	trust
هِياتَة	N	loitering
دَرَّس	V	instruct
شَرَح	V	explain
راسِب	ADJ	flunking
تَرتِيب	N	arrangement
وَداعَة	N	meekness
اَعمَى	ADJ	blind
مِبَوِّز	ADJ	frowning
تِحَطَّم	V	disintegration
نَحس	N	ill-fated
قَرادَة	N	miss-
ثَقَّل	V	become_laden
صَدَق	V	be_sincere
مَشي	N	walking
قاد	V	pilot
اقوَى	ADJ	most_powerful
مَصدُوم	ADJ	shocked
خافِت	ADJ	dim
شَمعَة	N	candle
مِنَوِّر	ADJ	shining
لَحم	N	meat
نَسِيم	N	side
شِتاء	N	rain
اَجِر	N	fees
حِساب	N	calculation
رَشوَة	N	bribes
اِبتَلَش	V	get_stuck_with
رُمانسِيَّة	N	romanticism
مَول	N	mall
بِرِستِيج	N	prestige
طَماطَة	N	tomato
مِسرِف	ADJ	overly
اَبَي	V	desire
هَجَم	V	attack
اِنلَحَس	V	be_eaten_away_at
خَسارَة	N	damage
اِنفَتَح	V	be_responsive
حاطّ	V	walk_away
حَوَّط	V	cruise
مِسكِين	N	humble
دَفَّا	V	heat
اِنشَلّ	V	be_paralyzed
صاخّ	ADJ	listening
دَفوَة	N	heat
مِبَنِّد	ADJ	lock
مِوَدِّر	ADJ	closing
كَحّال	N	antimony
جِلُوس	N	lip_gloss
قَفَط	V	dismay
زَين	N	beauty
قافِط	ADJ	frustrated
مِسَجِّل	N	recorder
طَرَر	N	crystal_clear
خَسا	V	do_bad
مَجرُوح	ADJ	wounded
نَطَر	V	expect
مِتحَرقِص	ADJ	tense
تِمَعَّن	N	close_examination
خَلَق	V	shape
عُذر	N	excuse_me
داوَى	V	treat
تَحَرَّى	V	think
بايِن	ADJ	plain
فَشلَة	N	scandal
مِتوَسِّط	ADJ	average
رِمش	N	eyelash
مَقرُون	ADJ	connected
مِرَتَّب	ADJ	arranged
نِحِيف	ADJ	emaciated
سَلسَبِيل	ADJ	fresh_cool_water
مِطَوَّل	ADJ	lengthen
مِغَطِّي	ADJ	covering
لَوَّع	V	torment
لايِع	ADJ	tormenting
سَفَّل	V	revile
اِعادَة	N	re-(doing)
مَنهَج	N	method
مُحَلَّل	ADJ	analyzed
خَشّ	V	conceal
فِشِيلَة	N	wrath
حِمِير	N	donkey
لافّ	ADJ	tying
مِطَلِّع	ADJ	making_it_go_out
مِخَلِّي	N	letting
تِأَدَّب	V	be_educated
دَعَم	V	strike
بِنغالِي	ADJ	bengali
عامِل	N	agent
نَظافَة	N	cleaning
مَشعَر	N	emotion
رِيشَة	N	feather
شَفَّاف	ADJ	translucent
مِرَكَّز	ADJ	concentrating
اَحرَج	V	be_confined
مِتذَكَّر	ADJ	remembering
جَعَل	V	bring_about
خَلا	V	evacuate
زَهبَة	N	belonging
خَصر	N	waist
اَدَب	N	literature
طالِب	ADJ	requesting
خِصِّيص	ADJ	especially
خَرطَة	N	untruth
خَرَّاط	ADJ	lier
كَذّاب	ADJ	liar
اَحلَى	ADJ	sweeter
مَنظَر	N	view
ماسِخ	ADJ	tasteless
دَحّ	N	filling
لَذِيذ	ADJ	pleasant
مِتفَنِّن	ADJ	cultured
دَلَّع	V	flirt
تِفَنَّن	V	be_diversified
لَيسِن	N	license
رَتَّب	V	be_managed
تِحَمَّس	V	be_enthusiastic
اِستَعجَل	V	hurry_up
اِفتَشَل	V	be_irritated
تفَننُّن	N	originality
اِرتَبَك	V	be_perpetrated
لَطَّف	V	soften
دار	N	house
مِعَذِّب	ADJ	torturing
تِفاءَل	V	be_optimistic
ثِقِيل	ADJ	oppressive
ذايِب	ADJ	dissolved
تَرَجَّى	V	expect
اَطرَى	V	flatter
هَوَّن	V	facilitate
بُرُودَة	N	coldness
خًاف	V	be_afraid_(of)
عاطي	ADJ	donor
جامَل	V	be_amiable
طاهِر	ADJ	clean
هَوَى	V	love
فُلان	N	so-and-so
غامَر	V	gamble
جانِي	ADJ	delinquent
عَطشان	N	thirsty
شَجَن	N	anxiety
نَدمان	ADJ	repentant
كِفايَة	N	enough
خِلّ	N	friend
بَدَّد	V	surprise
سَهران	ADJ	watchful
مَنفِي	ADJ	exiled
ساكِن	N	inhabitant
وَطَن	N	nation
ضِدّ	N	anti-
هِجران	N	desertion
وِجدان	N	emotion
اِصطَنَع	V	manufacture
زاخّ	ADJ	holding
فَلَت	V	escape
اِستَسلَم	V	capitulate
لِياقَة	N	competence
تِهَوَّر	V	collapse
تَوازُن	N	balancing
شاطِئ	N	coast
مَلحُوظ	ADJ	remarkable
اِنخَرَس	V	inundate
عَباءَة	N	cloak
رَعَش	V	shake
خاطِف	ADJ	passing
مَفضُوح	ADJ	disgraced
كاشِف	ADJ	revealing
مِعَمَّاى	ADJ	blinded
دَفَّايَة	N	stoves
خَرَّس	V	inundate
فاد	V	beeful
شاغِل	ADJ	functioning
مِكابِر	N	arrogance
مِستانِس	ADJ	sociable
شَقِي	ADJ	bloody
بَيزِي	ADJ	busy
خَرسان	ADJ	wet
دَفَّى	V	feel_warm
اِنفَعَل	V	be_affected
تِنَرفَز	V	go_mad
ظَبَط	V	regulate
اِنجَذَب	V	be_attracted
اسف	ADJ	sorry
حاد	V	know
فُقدان	N	loss
اِنعَصَر	V	be_squeezed
اَحزَن	V	sadden
مِعَوِّر	ADJ	painful
مُعاملَة	N	treatment
تِأَثَر	V	be_affected
تِشَمَّت	V	gloat
تِدَفَّى	V	be_warmed
دَفَى	V	heat
اِنشَوَى	V	be_grilled
مُستَعان	ADJ	asked_for_help
صَبَّر	V	stabilize
وَكِيل	N	agent
داهِيَة	N	calamity
عَقرَب	N	scorpion
شَيفَة	N	seeing, viewing, sight
وِسواس	N	temptation
مِستَوعِب	ADJ	understanding
رَكَّز	V	focus
ساقِط	ADJ	failing
صَبع	N	finger
اَفظَع	ADJ	most_abominable
مِستِوِي	ADJ	straight
مِبَركِن	ADJ	parking
تِضارَب	V	quarrel
حَقَّر	V	disparage
عِتاب	N	reprimand
لَوم	N	censure
تَقلِيدِي	ADJ	traditional
مالِك	ADJ	writing_wedding_contract
مَنقُوض	ADJ	violated
صُلب	N	core
مَمنُوع	ADJ	prohibited
تِعَنَّى	V	intend
شارِع	ADJ	street
طَبّ	V	enter_suddenly
اِقتَنَع	V	be_convinced
تَحَضَّر	V	civilize
تَحَضُّر	N	civility
خَربَطَة	N	disorder
مِتلاقِي	ADJ	meeting
مَقبُوض	ADJ	arrested
كايِِد	ADJ	arduous
حَدَث	N	event
حَشِيم	ADJ	bashful
حَسِيب	N	noble
رَقِيب	N	observer
غَلَط	V	err
طَمّ	ADJ	stupid
طَمّ	V	hit
سافِل	ADJ	lowly
رِضا	N	pleasure
اِنطَرَى	V	be_remembered
شَين	N	disfigurement
سَرج	N	saddle
بُومَة	N	an_owl
خَسفَة	N	repulse
اِتشاهَد	V	be_observed
نِبِي	N	massengers
نَقَد	V	criticize
داشّ	ADJ	entering
عايِف	ADJ	unwilling
عاف	V	hate
حابّ	ADJ	liking
سُوسَة	N	woodworm
حَقِيقَة	N	truth
طَمَع	N	ambition
عَلِيّ	ADJ	high
رَغِيد	ADJ	carefree
مَخنُوق	ADJ	strangled
شَوجِن	N	shogun
هاس	V	pressurize
تاكسِي	N	taxi
طَمأَن	V	calm_down
خِبال	N	insanity
سَقف	N	roof
شُبهَة	N	suspicion
مِتغَرِّق	ADJ	pouring_out
لاصَق	V	be_in_touch_with
مَبحُوح	ADJ	hoarse
صَفَّى	V	liquidate
تِقَلَّب	V	turn_around
قُرآن	N	quran
داقّ	ADJ	knocking
واعَى	V	warn
اِمتَحَن	V	be_tested
كَمِّيَّة	N	amount
واصِل	V	continue
مُوَدِّر	ADJ	leaving
مِطَّمَّن	ADJ	calm
سَهَّر	V	keep_up_late
عاشِق	ADJ	fond_of
اَحرَق	V	burn
حَرق	N	burning
تِقَطَّع	V	be_interrupted
مِتلَهِّف	ADJ	yearning
عَرُوسَة	N	bride
مِتشائِم	ADJ	pessimistic
مُرّ	ADJ	bitter
مُقتَطَف	N	snippet
كَوفِي	N	coffee
صَحصَح	V	wake_up
تَوعِيد	N	promise
قَرقَر	V	grumble
نِسكافِيه	N	nescafé
سَدَّة	N	locker
كَرتُون	N	carton
غُورِي	N	pitcher
فَوَّر	V	boil
فار	V	gush_out
زايغ	ADJ	wandering
فار	N	mouse
عَكَس	V	reverse
مِستِحَى	N	bashfulness
نَبَض	V	throb
تِخربَط	V	be_confused
حَدَى	V	sing
عَشَق	V	love
اَشبَع	V	be_gratified
رَخَّص	V	license
كَون	N	being
اَوَّلانِي	ADJ	first-place
تِعَمَّد	V	do_deliberately
تِلَعثَم	V	stammer
عَمد	N	deliberately
حَوش	N	courtyard
مَصرِي	ADJ	egyptian
عاوِز	ADJ	wanting
جَوز	N	wife
تَثاوَب	V	yawn
قُوطِي	N	navel
نِشبَة	N	concerning
مِسَطَّل	ADJ	intoxicated
فاينَل	N	final_exam
بَدرِي	ADJ	some_time_ago
تَيك	V	take
كَير	N	care
مِصفِرّ	ADJ	yellow
شاحِب	ADJ	emaciated
حَرَّج	V	become_difficult
اَريَح	ADJ	more_comfortable
صَدعَة	N	headache
اِستَودَع	V	deposit_in
حَرَس	V	supervise
قَلّامَة	N	pencil_case
وَفَّق	V	grant_success
كَفُو	ADJ	competent
مَعرِفَة	N	education
تِزَهَّب	V	prepare
تِكَفَّل	V	be_legal_guardian
مَيسد	ADJ	missed
كَول	N	call
سَهل	ADJ	simple
اَدَب	ADJ	literary
عِربان	N	qualified
جَدارَة	N	worthiness
اَخِر	ADJ	last
صافّ	ADJ	in_a_row
اِمتِياز	N	distinction
جَيِّد	ADJ	good
تَفّ	V	spit
حَسَد	N	envy
فاشِل	ADJ	failing
اَحبَط	V	thwart
قَيَّل	V	move_away
مُلك	N	dominion
تافِه	ADJ	trivial
صَفّ	V	shunt
رُسُوب	N	precipitation
نَوَّع	V	diversify
سِبال	N	monkey
لَصقَة	ADJ	adhesive
اِنلام	V	be_blamed
حَوبَة	N	misdeed
اِضّارَب	V	be_hit
مِتمَلَّل	ADJ	mpatient
اِنتَقَد	V	criticize
قِشرَة	N	shell
مَلّان	ADJ	dissatisfied
كابَر	V	contend_with
فَهِّيم	ADJ	intelligent
مَظلُوم	ADJ	oppressed
قِيمَة	N	value
اُمَّة	N	peoples
خَقّ	V	be_haughty
مَعلُوم	ADJ	known
فانِيلّا	N	vanilla
شُكُولاتَة	N	chocolate
نَقَع	V	be_erupted
كَنز	N	treasures
مِكَسَّرَة	N	piece_of_nuts
جَمِيع	N	all
سِرّ	N	secret
ثَبَت	V	be_pregnant
رَبَط	V	tie
حَكِيم	ADJ	wise
دَحّ	V	be_hit
غَصّ	V	be_crowded
صارُوخ	ADJ	quick
اَيِسكِرَيم	N	ice_cream
ذاب	V	belt
مِفَشِّل	ADJ	scandalous
قَبقاب	N	sandal
طارِي	ADJ	mentioning
تَصرِيفَة	N	selling
مِغَلِّط	ADJ	at_fault
قَوَّى	V	strengthen
هَدَف	N	goal
اِنشَغَل	V	be_occupied
صَلَح	V	be_valid
مِعَرِّس	ADJ	married
نادِر	N	seldom)
اِنقَرَص	V	be_pinched
شاطِر	ADJ	clever
طالِب	N	student
مُعَلِّم	N	teacher
فاضِل	ADJ	honorable
قَرَف	V	peel
عَفوِي	ADJ	spontaneously
مِداوِم	ADJ	in_office
نُونَة	N	scowling
تِدَلَّع	V	pamper
وايَق	V	gaze
اِنخَشّ	V	be_hidden
لَيمُون	N	lemon
نَعناع	N	mint
جُرأَة	N	boldness
مَشَع	V	pull_out
لاق	V	be_suitable_for
ساح	V	melt_down
اِبداع	N	originality
بَرّ	N	earth
حَلَّى	V	sweeten
حَظِيرَة	N	hangar
ضَوّ	N	light
مُوراي	ADJ	burning
تِفَوَّت	V	let_pass_through
اِحلَوّ	V	be_sweeten
جَفن	N	eyelid
جَفا	N	staleness
مِتصَوِّب	N	pointed
مَمحُون	ADJ	in_distress
ضَوَّى	V	illuminate
طَيف	N	spectrum_(light)
خَيال	ADJ	fantasy
مَطعُون	ADJ	infected
تَراءَى	V	appear
غُرّ	N	jay
باهَي	ADJ	beautiful
هُدب	N	eyelash
نَزَع	V	divest
مَسنُون	ADJ	sharpened
عُود	ADJ	lutes
مَيّال	ADJ	swaying
هايِف	ADJ	svelte
مَفتُون	ADJ	possessed
تِغَلَّى	V	be_more_dear
شاعِر	N	sensing
بُخل	N	stinginess
بَخِيل	ADJ	miser
مَشغَلَة	N	employ
مِسَوِّد	ADJ	black
مَقبُول	ADJ	admitted
وَنِيس	N	sociable
اِستَرخَص	V	request_authorization
عَون	N	assistant
اِتلَبَس	V	dress
خالِص	ADJ	finishing
تِدَخَّن	V	be_incensed
مُوتَر	N	automobile
مُونَة	N	mortar
تَحدِيد	N	delimitation
اِنطَبّ	V	get_lost
قالِب	ADJ	turning_around
دُخُون	N	frankincense
سَواد	N	populace
هَذرَة	N	speech
حَلّل	V	analyze
حَنِين	N	nostalgia
تَحَوَّط	V	wander
راعي	ADJ	sponsor
مِدَخَّن	N	smoked
طابِق	N	floor
لَقَّط	V	gather
خًاطِر	N	wish
لَوحَة	N	painting
فَنِّي	ADJ	technical
جار	V	be_parallel
فَزّ	V	leap
كُركُمِي	ADJ	turmeric
بَطَة	N	duck
تَغَيَّظ	V	be_irritated
مُجهَد	ADJ	strenuous
زُكام	N	common_cold
عاجِل	N	accelerating
تِقَهَّى	V	drink_coffee
زَيَّغ	V	terrify
خَسّ	V	silence
تِلَقَّف	V	face
تِلاقَف	V	face
عاكِس	ADJ	reflecting
عَدِيم	ADJ	devoid_of
غَيَّظ	V	irritate
حَلَى	N	sweetness
سِتِي	N	city
لُوتِي	ADJ	venal
تِعَلِّيل	N	night_without_sleep
تِجافِي	N	harshness
مِرتِبِش	ADJ	firm
باركِن	N	parking
تِحَوَّط	V	patrol
رَفّ	N	shelf
مِنتِقِب	ADJ	covered
حاط	V	guard
عِدَّال	N	side
بُكرَة	N	tomorrow
نَزَّل	V	download
حَبُّوب	N	sweety
اِعتَرَض	V	be_opposed_to
اِنتَقَل	V	move
قَرِيب	N	recent
تِدانَى	V	get_closer
اِفتَرّ	V	broach
خِدِّي	N	stupid
تِخَرَّص	V	expect
سَمِح	ADJ	polite
اَتعَب	V	bother
قَرّ	V	settle_down
مِرَوِّح	ADJ	going_home
حَجم	N	volume
ناد	V	doze_off
مِوَصِّل	N	arriving
جالِس	N	sitting
طارِش	N	assistant
سَدَح	V	turn_on
سِيت	N	seat
غَشوَة	N	covering
لاع	V	torment
سادِح	ADJ	imposing
سَرحان	N	roaming_freely
بِلَى	V	be_hit
لُزُوم	N	exigency
رَمَسَة	N	speech
فُندُق	N	hotel
غاظ	V	irritate
اِتطَرَّى	V	mean
غَرشُوب	ADJ	beautiful
عِيال	N	son
عاقّ	ADJ	taking_off
طَشّ	N	shower
رَشّ	N	sprinkling
اَسفَر	V	be_bright
اَنوَر	V	come_to_light
اِتغَدَّى	V	have_breakfast
مَنطُوق	N	statement
لَفَى	V	arrive
طارِِي	N	memory
مِعَزِّم	ADJ	departing
بَيات	N	lodging
راد	V	desire
جاي	ADJ	comming
اَربَعاء	N	wednesday
هِدايَة	N	guidance
قُشار	N	item
قَحفِيَّة	N	gahfiah
لَقطَة	N	video
مِسَهِّر	N	to_make_sleepless
عَلَم	V	find_out
بَيَّت	V	remain
مِتزَهِّب	ADJ	equipped
ثَنَوِيَّة	N	secondary
ثِنتَين	N	two
صَكّ	ADJ	heat
قَصِيدَة	N	poem
سِطار	N	side
اَزاد	V	provide
اَخجَل	V	be_embarrassed
تَواضُع	N	modesty
حَظِي	V	enjoy
اَنعَم	V	be_bestown_favors
رِدِيد	ADJ	ready
رَكض	N	race
رَئِيسِي	ADJ	principal
تِرَخَّص	V	say_goodbye
اَوَّلي	ADJ	first-place
كَبّ	V	anemone
خَيَّس	V	annoy
اِرتَبَش	V	be_confused
عاكِس	N	reflector
سَهالَة	N	ease
مِحوَر	N	pivot
حَدِيث	N	hadith_(islamic_tradition)
غَلا	ADJ	precious
تِفَدَّى	V	ransom
تِوالَف	V	associate_with
رِباعَة	N	accompanied
تِخَبَّر	V	be_informed
مِشَخِّط	ADJ	mistreating
غافَل	V	exploit_negligence
فُودَة	N	napkin
غَفُور	ADJ	forgiving
حَيا	V	witness
تِناغَز	V	signal_to_each_other
لام	V	censure
سَهَر	V	stay_up
غَمضَة	N	winking
ساوَى	V	be_settled
غَلَّى	V	make_love
هَجِر	N	separation
غَلَى	N	dearness
ناسِي	ADJ	forgetting
اِفتَخَر	V	be_proud
غَمَّد	V	conceal
جَنَّة	N	paradise
قِوَى	V	become_strong
قايِل	N	person_who_says
مَطَر	N	rain
اَضَوَى	V	weaken
مَرَض	V	disease
دُكّان	N	shop
خَلِيّ	ADJ	free
لاف	V	go_through
مَرخُوص	ADJ	provided
بُول	N	bull
هَبّ	V	do_bad
حَيّ	N	living_thing
اَعَدَم	V	be_deprived
شِراع	N	tent
بُرتُقال	N	orang
بَيزَة	N	money
فِرِشّ	ADJ	fresh
شَيبَة	N	make_gray-haired
ذايِق	N	experiencing
مُرّ	N	bitter
شَل	V	lift
اِستَغنَى	V	dispense_with
كُلِّيَّة	N	college
وَجَّه	V	face
مُستَقطِع	ADJ	boycotting
مَمزُور	ADJ	replete
كَبت	N	cupboard
كَشتَة	N	career
رُوح	N	same
حايَل	V	entreat
مَقلَب	N	dumping_grounds
صِفر	N	zero
تَزهِيب	N	preparing
عَبالَة	N	weary
شَيمَة	N	natural_disposition
عِنّابِي	ADJ	russet
اَصبَحَ	V	start
مُوَقِّف	ADJ	standing
شَوف	N	look
تَحتِيّ	ADJ	infra-
نِصفانِيّ	ADJ	middle
عَوَق	N	disease
اِنرَشّ	V	be_sprayed
اِنتِقام	N	in_revenge
مَردُود	ADJ	returned_back
فَرَش	V	spread
حَصِير	N	mat
كَوار	N	the_metallic_boxed_grill_that_you_light_charcoal_in
تَلاغَى	V	be_able
تِيَبَّس	V	firm
حَقّ	V	be_correct
مَتِين	ADJ	firm
بَشرَة	N	skin
غَمّازَة	N	dimple
اِحمِرار	N	reddening
غامِق	ADJ	deep_color
ثَمّ	N	mouth
مايِل	ADJ	tilted
بُنِّي	N	brown
تَجهِيز	N	preparing
سارِح	N	roaming_freely
تِجَهَّز	V	be_furnished
وَعرَة	N	impassibility
جَبَل	N	mountain
ثَبان	N	protection
مِتلَبَّس	ADJ	wearing
هَزَّب	V	calm
اَخال	V	be_afraid
ضارِب	ADJ	tending_towards
عَصاة	N	baton
بِن	N	son
تِغَربَل	V	be_confused
اَرضِيّ	ADJ	land
تِكَوَّن	V	consist_of
غَسُول	N	detergent
عَدلَة	ADJ	correct
اِنكَفَظ	V	hasten
اَنَس	V	entertain
سَحِيح	N	date
سَحّ	N	date
رابِط	ADJ	tying
مَجَلَّة	N	journal
تِحَنحَن	V	hem
مَدعَمِيَّة	N	supporter
اِتاَكَد	V	confirm
حَوض	N	reservoir
ضُفدَع	N	frog
بَغَض	V	hate
رَوَّغ	V	dodge
تَرابَع	V	race
اَبدَع	V	innovate
اَغوَى	ADJ	mislead
صِدق	V	sincerity
يُوالَة	N	yowala
غِنِيَّة	N	song
مِغَيِّم	ADJ	cloudy
بايِت	ADJ	old
كَلاشِن	N	kalashn
تِلاحَق	V	follow_successively
مِقابلَة	N	in_exchange_for
خُصُوص	N	issue
عَظم	N	bones
مَظبُوط	ADJ	established_facts
لايِق	ADJ	appropriate
نُعُومَة	N	smoothness
شِبِيبَة	N	youthfulness
ظَهَّر	V	extract
لِبانَة	N	chewing_gum
سار	N	move
غَرشَة	N	glass
غَطاة	N	cover
عَطَّر	V	apply_perfume_to
مِعَطِّر	ADJ	applying_perfume_to
مِتعَطِّر	ADJ	perfumed
قاوَم	V	be_resisted
شِدَّة	N	intensity
كِيرم	N	carrom
هَفّ	V	take
عَطشان	ADJ	thirsty
مِخَلِّص	ADJ	be_finish
زاغ	V	deviate
مِتلَثِّم	ADJ	veiled
مِتسانِد	ADJ	leaning
مُصَلِّي	N	person_worshipping
رَبَّع	V	fold
مَخبا	N	sine
مَكتُوب	ADJ	written
خاطَر	N	wish
رِسالَة	N	mission
مُوَجَّه	ADJ	directed
مِرباي	ADJ	educated
مِتوَفِّي	ADJ	deceased
دَسّ	V	conceal
تَلبِيس	N	coating
طائِر	N	bird
عازِم	ADJ	hosting
طَربُوشَة	N	fez
غَيران	ADJ	jealous
رَقَب	V	supervise
طايِر	N	meal
اَلَّف	V	compose
حامِل	N	pregnant
صَيف	N	summer
سِينِما	N	cinema
مِشتِهِي	ADJ	desiring
مُكَعَّب	N	cube
عَشَّى	V	give_dinner
مِيرَة	N	mera
دَوَّامَة	N	dizziness
مَهرَجان	N	festival
تِراث	N	inheritance
عُوق	N	affliction
تِفَيَّق	V	excel
خايِن	ADJ	traitor
كَيكَة	N	cake
كاكاو	N	cacao
لُغز	N	riddles
تِوَصَّل	V	arrive
شَقَّة	N	apartment
جِهاز	N	appliance
صَبر	N	patience
مِتوَلِّه	ADJ	bewildered
تِصَوَّر	V	imagine
عَن	N	over
اَعدَم	V	be_deprived
عَبَّل	V	bother
عَنَّى	V	strain
مِطَيَّح	ADJ	stray
شَكَى	V	complain
باس	N	bad
تِوَلَّه	V	become_insane
لاحِق	ADJ	joined
عَرَب	N	qualified
اَربَع	N	wednesday
غُربَة	N	exile
نَذالَة	N	depravity
بِكر	N	young_camel
اِنجِلِيزِي	N	english
تُوبّـ	N	top
اِجتِماعيّ	ADJ	social
اِختَلَط	V	be_friendly
مُشَجِّع	N	proponent
نادِي	N	club
حَبُّوب	ADJ	friendly
اِلتِهَى	V	be_entertained
تِحَجَّب	V	wear_veil
قاطِع	ADJ	conclusive
رَفَّه	V	make_pleasant
دَرّاجَة	N	bicycle
خَرِيط	N	falsehood
تارِس	ADJ	flock
كاد	V	no_sooner
شُرطَة	N	police
تاج	N	crown
ضِرابَة	N	fight
قَرن	N	horn
بِزنِس	N	business
مان	N	man
بات	N	bat
عَيناوِي	ADJ	from_al-ain
مَطلُوب	N	necessary
مُستَصنَع	ADJ	synthetic
رِفقَة	N	along_with
رَفَق	V	treat_gently
مانِع	N	impediment
طَفَّر	V	annoy
غَلاسَة	N	obnoxiousness
تِضَيَّق	V	become_up_set
شَبَّك	V	entwine
مُوافَقَة	N	agreement
رَمس	N	speech
يَومِيّ	ADJ	daily
اُختـ	N	counterpart
تَوزِيع	N	distribution
تالِي	ADJ	following
ضَيف	N	guest
طالَب	ADJ	requiring
لاوِي	ADJ	tilted
خَدَّامَة	N	servant
جَذَب	V	pull
سَيطَرَة	N	dominion
اِنذَبَح	V	be_sacrificed
مِفَرفِش	ADJ	happy
دَجاجَة	N	hen
فَوَّت	V	skip
بَطَل	N	star
مُعجِزَة	N	miracle
كاظّ	ADJ	forcing
سَهرَة	N	evening_gathering
مِجَهِّز	ADJ	preparing
خَراب	N	destroyed
بَرطَم	V	talk_nonsense
فَضَى	V	break_up
مَكِينَة	N	machine
ضُحَى	N	overnight
كَراج	N	garage
فَصَّص	V	search
خام	ADJ	repulsive
طَفَر	V	seize_(opportunity)
هَقَى	V	expect
ضاحِيَة	N	neighborhoods
اِستَقطَع	V	deduct
تِغَزَّل	V	flirt_with
مِسرِع	N	in_a_hurry
صِرفَة	N	cancellation
نَفَد	V	get_away
تَكمِلَة	N	supplement
سَبّ	N	cursing
ذَلَف	V	abandon
فِشَل	V	fail
مَكتَبَة	N	bookstores
مِعَقِّد	ADJ	lifting
مِتمَسِّح	ADJ	performing_ablutions
خَمَّن	V	conjecture
تَمَلمَل	V	become_impatient_with
كِوَيتِي	ADJ	kuwait
مِتغَتَّر	ADJ	wearing_ghatra
فُرن	N	oven
قُوزِي	N	quzi
مَسخَرَة	N	ridiculousness
قَلّ	V	decreased
اخّـ	N	brother
مَصُون	ADJ	protected
اِحتَرّ	V	become_up_set
غَلَّّس	V	be_stupid
كِرِيما	N	cream
بَلَكَونَة	N	balcony
جَمعِيَّة	N	society
بَيبِي	N	baby
اَحرَى	N	better
وِجهَة	N	institution
سَكَن	V	live
غَرِيب	N	stranger
شاوَر	V	make_a_signal
بِرنامِج	N	program
مِستِرِيح	ADJ	relaxed
هَمبا	N	mango
مَلح	N	salt
تِرَقَّب	V	watch
رَقدَة	N	sleep
مُساعَدَة	N	help
مَلَّح	V	season_with_salt
عادَى	V	contaminate
تِنَشَّد	V	inquire
اِتفَجَّج	V	get_rid_of
جِرِيء	ADJ	courageous
مِتحَسِّف	ADJ	sorry
كِذِي	N	like_this
ثَمَن	N	price
مِحايَلَة	N	many_trials
دُفعَة	N	instance
اِستَفرَد	V	isolate
واثِق	N	confident
تِواعَد	V	arrange_aeting
مَقصُود	ADJ	meant
شَقَح	V	be_cheerful
وَصلاوِي	ADJ	of
اِنتَهَز	V	take_advantage_of
تِقَهوَى	V	drink_coffee
نَفَى	V	deny
عامَّة	N	in_general
تَقلِيد	N	custom
اَصلِيّ	ADJ	original
وَلَه	N	bewilderment
بِعاد	N	distance
لُقا	N	encounter
اَظهَر	V	manifest
مَعزُوم	ADJ	invited
تَمام	N	exact
مِتكَشِّخ	ADJ	looked_elegant
تِكَشَّخ	V	look_elegant
تَعَشَّى	V	dine
مُخَطَّط	N	sketch
عَجِيب	ADJ	amazing
مُخَطَّط	ADJ	sketch
اِنخَمَد	V	calm_down
مِغايِظ	N	teasing
سَمَّاعَة	N	telephone_receiver
اِقناع	N	persuasion
عامِل	ADJ	active
تَحَلَّف	V	make_someone_promise
سَفّاح	N	shedder_of_blood
ضَمان	N	insurance
مِطَقِّم	ADJ	coordinating
حاطِط	N	putting
قِلُوس	N	lip_gloss
لابتَوب	N	laptop
حُبارَى	N	bustard
تِمَنظَر	V	inspect
اَدنَى	ADJ	smallest
كُومِيدِي	ADJ	comic
تِلَقَّى	V	bet
تَحضِيرِي	ADJ	preparatory
قَبلِي	N	previous
شارَف	V	get_close_to
اِنكَبّ	V	fall
خَسَّس	V	reduce
كاشِف	N	caller_id
عَجازَة	N	laziness
نَزلَة	N	getting_down
اِتلَقَّف	V	face
دَفتَر	N	ledger
شارِي	ADJ	buying
بائِس	ADJ	dejected
هَنا	V	be_wholesome
طَرّ	V	sharpen
عَطسَة	N	sneezing
كِلِينِكس	N	tissue
عَطَس	V	sneeze
شَمَّت	V	say_god_bless
مُتابَعَة	N	pursuit
غاسِل	ADJ	winner
تَعِيس	ADJ	wretched
اَغرَب	ADJ	stranger
اَتعَس	ADJ	miserably
عَمالَة	N	precisely
مُجَرِّب	ADJ	tester
رَحمان	ADJ	merciful
عَزاء	N	consolation
سَمُوحَة	N	forgiveness
مِصَلِّي	ADJ	praying
ناشّ	ADJ	standing
مِفتِخِر	ADJ	vainglorious
وَلَّع	V	set_fire_to
تِلَفَّت	V	turn
تَدارَك	V	correct
عُقدَة	N	complex
تَغَتَّر	V	wear_ghatra
مِتعَدَّل	ADJ	decorated
خافِق	N	heart
خَيمَة	N	tent
بارِح	N	yesterday
عِدَّة	N	material
كثاف	ADJ	heavy
كَفَن	N	shroud
رَكِّب	V	put_together
صادَف	V	concur
ضِلع	N	side
قُبَّعَة	N	cap
كابتِن	N	captain
مُبتَعِد	ADJ	be_far_away_(from)
شِيطان	N	devil
تَغَلغَل	V	invade
نَشاز	ADJ	prominent
طَلّ	V	face
مُتَحَرِّك	ADJ	mobile
مَقطَع	N	selection
مِدانِى	ADJ	able
تِوَفَّى	V	die
تَكَبُّر	N	arrogance
جَمِيل	N	beauty
وَجَع	ADJ	having_pain
مَشَى	V	walk_away
صالُونَة	N	a_dish_of_chicken_and_rice
ماعُون	N	container
تِوَسَّخ	V	be_dirty
سِوِيت	N	sweet
طَبخ	N	cuisine
مُثَقَّف	ADJ	cultivated
نِت	N	net
مِتفَوِّق	ADJ	superior
مِنحَة	N	gift
طِبّ	N	medical_treatment
مِفَكِّر	ADJ	be_think
رَسم	N	illustrating
تِعَمَّق	V	delve_into
واحدَة	N	one
بَيج	N	beige
خُصلَة	N	cluster
كَحَّل	V	painted_with_kohl
مِرايَة	N	mirror
ناعِس	ADJ	drowsy
هَيكَل	N	skeleton
مُحافِظ	ADJ	conservative
مَتَن	V	be_fat
بِنيَة	N	make-up
دُبّ	N	female_bear
بِلايِستَيشَن	N	play_station
مِتحَمِّس	ADJ	enthusiast
مادَّة	ADJ	be_extend
مُنفَرِد	ADJ	detached
تِعافَد	V	jump
اِتحَرَّط	V	flirt
صَوَّب	V	rectify
نارِيّ	ADJ	fire
حَضَّر	V	prepare
سُفرَة	N	dining_table
اِلتَمّ	V	gather
حَرِيص	ADJ	eager
حذاي	N	face_to_face_with
سِتر	N	cover
مِسَوِّي	N	do
ذِهن	N	mind
سارِح	ADJ	roaming_freely
سَرَحان	N	distracting
اِتدَرَّس	V	study
تِراجَع	V	retreat
تِنَحنَح	V	clear_the_throat
هَندَسَة	N	engineering
نقاش	N	debate
ضَحِيَّة	N	victim
قُصُور	N	dificiency
خِلال	N	through
اِيجابِي	ADJ	positive
غَرِيزَة	N	natural_instinct
جافّ	ADJ	stiff
مِتفَهِّم	N	reasonable
مُنفَتِح	ADJ	tolerant
عَميا	ADJ	blind
مَعدُوم	ADJ	vanished
طاغِي	ADJ	oppressor
بَهجَة	N	splendor
اِختَلَى	V	retire
اِنغَرَس	V	be_implanted
مِتخَرِّج	ADJ	graduated
مَعاش	N	income
تَبذِير	N	squandering
فلوس	N	money
دَبَّر	V	arrange
بِيتزا	N	pizza
شارِب	ADJ	drinking
تَمالَك	V	control
مَضَى	V	run_out
اصفَر	ADJ	yellow
بِلعَوم	N	esophagus
مِأَخِّر	ADJ	make_delayed
كامِل	N	integral
ماتَور	N	motor
فِتِك	ADJ	outstandingly_able
كَبِير	N	adult
عِزّابِي	ADJ	single
سَولَف	V	talk
لاهِي	ADJ	oblivious
شَرَّش	V	take_root
مَصاخَة	N	the_action_to_be_bland
عَفَد	V	leap
عُقبال	N	wishing
كِيُوت	ADJ	cute
قِرد	N	monkey
اِسم	N	name
فاوَل	V	---
شَفَط	V	siphon_out
شفاة	N	lip
تِمَصخَر	V	joke
هَذرَبان	N	empty_talk, balderdash, nonsense
اِنتِظام	N	regularity
ظالِم	N	oppressor
مَعلُوم	N	known
بَلسَم	N	balsam
مَسا	N	evening
اِندَقّ	V	be_knock
شَعرَة	N	hair
طُول	ADJ	long
اُمَّاه	N	mather
مِخمَلِي	ADJ	velvety
ثُنائِيّ	ADJ	dual
شَرِس	ADJ	vicious
اَزوَد	ADJ	more_than
لَبَّى	V	comply_with
قِطَعَة	N	pieces
جاهِل	ADJ	ignorant
تِغَيَّر	N	modify
تِطَلَّق	V	divorce
تَغَطَّى	V	be_covered
وَعَى	V	pay_attention_to
شَطَرَنج	N	chess
رِسَم	V	paint
تَعَبَّث	V	toy
هاند	N	hand
باج	N	bag
مُطَرَّز	ADJ	embroidered
شَعرة	N	hair
مِستِلِم	ADJ	receiving
سِيجارَة	N	cigarette
فاح	V	emanate
كَتَّف	V	cross_arms
اَصلَح	V	repair
اِنحَرَق	V	be_burned
رَسمِيَّة	N	formality
تَنُّورَة	N	skirt
مُسوَدَّة	ADJ	blacken
شَرا	V	buy
بُوت	N	face_to_face_with
شِرِّير	ADJ	bad_guy_(film)
رَفَس	V	kick_each_other
شُورت	N	trouser
مُنكَر	N	abomination
خَرط	N	lie
تِحايَل	V	get_through
شارى	V	buy
بَوس	N	kissing
كَبكَيك	N	cupcake
كَيك	N	cake
تَفَنَّن	V	variegate
بِلاك	N	phone
صَوَّر	V	photograph
كَب	N	cup
كام	N	camera
تَوّ	N	immediately
صَنَم	N	image
ذَمَّ	V	criticize
مَزُوحِي	ADJ	jocular
اِعدادِي	ADJ	preliminary
تَباهَى	V	be_vain
اِرتَمَى	V	fall_prostrate
فِراش	N	household_effects
ثَبَّت	V	install
تَسجِيل	N	registration
تَصوِير	N	filming
فُتُغرافِي	ADJ	photographic
شَكَّل	V	form
عَطَش	N	thirst
تَهَيَّأ	V	be_mobilized
تَعَوَّذ	V	seek_protection
اِنفَجَع	V	shock
رَثَى	V	elegize
تَجَمَّد	V	harden
اِنذَرَع	V	be_stable
تَثَبَّت	V	be_stable
تَمايَل	V	swing
سَكران	N	intoxicated
حَرِير	N	silk
حَمَى	V	defend
سَكران	ADJ	intoxicated
اِتقَزَّز	V	revolt
جانِبِي	ADJ	side
مِتلَخبَط	ADJ	confused
اِنتِباه	N	vigilance
فَراغ	N	vacuum
مُثَبَّت	ADJ	stable
سَرَّع	V	hasten
حَذَّر	V	leave
سرَّع	V	hurry
شاحِنَة	N	lorry
نَجا	V	be_rescued
مُتَسَبِّب	N	causer
اِنحَرَف	V	deviate
دَعَس	V	step_on
خِيانَة	N	treason
اَضعَف	ADJ	weakest
تَرَدَّد	V	be_hesitant
مالِي	ADJ	be_fill_out
سَدَّح	V	make_lie_down
وَعَّي	V	be_made_conscious
اِتوَضَّى	V	do_wudoo'"}
مِتمَلِّك	ADJ	controlling
عُشبِيّ	ADJ	herbal
تَكَحَّل	V	put_on_kohl
مُهمِل	ADJ	careless
بِلَوز	N	blouse
زايِغ	ADJ	confused
اِحتِكاك	N	friction
سَكَر	V	get_drunk
صَفعَة	N	blow
ضِرس	N	tooth
مِترَدِّد	ADJ	hesitating
اِحتَمَى	V	take_refuge
صَفقَة	N	deal
رِبح	N	interest
مَضمُون	ADJ	insured
كُلّ	N	every
تَقَسَّم	V	be_divided
كِتمان	N	secrecy
بِيزا	N	visa
مُتَطَلَّب	N	requirement
اَلُو	N	hello
مُتَفَيِّق	ADJ	waken
ثُلاثاء	N	tuesday
مَرَّن	V	train
ذاهِب	ADJ	going
جِبس	N	plaster_of_paris
بَسكَوت	N	cokies
لِبان	N	gum
مِتعايِز	ADJ	feel_tired
مُتَكاسِل	ADJ	lazy
اَورَد	V	import
اَيِس	N	ice
فِرِيز	N	sidewalk
زِبالَة	N	garbage
تَمر	N	date
كُورِي	ADJ	korean
دِينيّ	ADJ	religious
مُلتَهِي	ADJ	be_entertained
كَومَة	N	pile
عِشا	N	esha_prayer
بَول	N	ball
غامِض	ADJ	vague
تحَسَّب	V	suspect
مَفعُول	N	impact
خَطف	N	by_force
بَقَّق	V	pop_out
اَزرَق	ADJ	blue
تِيشِرت	N	shirt
تَطرِيز	N	embroidery
جامِع	N	extensive
اَسهَل	ADJ	easiest
كِلاس	N	class
مُدَرِّب	N	instructor
تُوفل	N	toefl
وُصُول	V	achieving
فَوشيا	ADJ	fuchsia
شَفَّر	V	---
كَسَل	N	negligence
جُوع	N	hungry
كافِر	ADJ	infidel
مَعكَرُونَة	N	macaroni
سَخَّن	V	make_hot
مِكرُوَيف	N	micro-wave
نَشاط	N	activity
حِزام	N	belt
تَطَبَّل	V	be_knocked
شَكَّك	V	give_suspicions
تَسَكَّر	V	be_closed
مَذَلَّة	N	humiliating
ذَلّ	V	humiliate
سَمَّم	V	poison
تَجادَل	V	debate
اِنسَحَب	V	pull_out
دِرِيم	N	dream
اَخَ	N	brother
كَم	N	some
تَدَلَّع	V	prim
مَغرُور	ADJ	deceived
اِستَقوَى	V	become_strong
تَحَسَّس	V	feel
مُبهَت	ADJ	be_pale
تسَدَّح	V	lie_down
سِتارَة	N	cover
زَرع	N	implanting_(artificial_heart)
مِعَلَّق	ADJ	commentator
رُطُوبَة	N	moistness
رُجُولِي	ADJ	manly
هامِس	ADJ	whispering
عَبِيط	ADJ	fool
لَهجَة	N	dialect
جاع	V	be_hungry
لَحَق	V	catch
لازانيا	N	some_kind_of_food
حار	ADJ	warm
مَغسَلَة	N	wash-stand
مِعدَة	N	stomach
حارّ	N	fervent
غَفلَة	N	negligence
فِلفِل	N	peppercorn
كَفِتِيريا	N	coffee_shop
فَيلس	N	---
بَهَت	V	assail
حَوَّل	V	change
دَرَّى	V	be_informed
شُرب	N	drinking
صَحا	V	wake_up
مَجهُول	ADJ	unidentified
تِحَوَّل	V	be_changed
وَضعِيَّة	N	status
جَنِين	N	germ
اِنكَمَش	V	be_preoccupied
حَسّاس	ADJ	sensor
تِخَلَّص	V	get_rid_of
سايلَنت	ADJ	silent
زُور	N	force
كَرك	N	tea_with_milk
اَعلَن	V	be_declared
اِتبَلَّى	V	claimed_falsely
نَبضَة	N	pulses
اِكسِسوار	N	accessory
قِياس	N	size
اِستِنتاج	N	conclusion
اِنعَرَف	V	be_known
سِيرامِيك	N	ceramic
ماركَة	N	trademark
رادوا	N	radu
جانِيل	N	janelle
عِيد	N	festival
مَعارِف	N	relatives
جَبّار	ADJ	almighty
جُمُود	N	inertia
غَلَّق	V	close
سُوِيت	N	suite
لاعَب	V	play
لاعَبَ	V	play
رِكاض	N	running
صالِح	N	advantages
فِيزَة	N	visa
اِتصَوَّر	V	imagine
اِندَفَن	V	be_hidden
تَنازَل	V	waive
جالاكسِي	N	galaxy
جالاكسي	N	galaxy
تَبَهدَل	V	be_in_disarray
اِستَنجَد	V	ask_for_assistance
تَنَسَّى	V	forget
تُحفَة	N	gift
كامِيرا	N	camera
فِلاش	N	flash
اِستَأنَسَ	V	be_sociable
هَنَّى	V	make_comfortable
مُسَطَّح	ADJ	level_plane
كارفُور	N	carrefour
غَتِيت	ADJ	disturbing
رَدَّ	V	answer
خَبَّرَ	V	be_informed
راغِب	ADJ	desire
نَجاة	N	salvation
ضَياع	N	waste
رُوب	N	curdled
شِفاة	N	lip
هِمَّة	N	ambition
خِرطِي	ADJ	naive
بابا	N	baba
حَطَّ	V	descend
تِهاوَش	V	quarrel
نَخلَة	N	date_palm
بَسكَوتَ	N	cokies
اَنانِي	ADJ	selfish
قُراءن	N	quran
فِدَى	N	ransom
اِحتِياج	N	need
هاجِس	N	notion
جازَف	V	gamble
اَفخَم	ADJ	more_splendid
طَبَّ	V	come_suddenly
دَستُور	N	---
مِتسَدِّح	ADJ	lying_down
مُندَمِج	ADJ	integrated
خَلِيجِي	ADJ	gulf
طَلَّة	N	view
نِظام	N	government
فَضَخ	V	strip_off
غَشمَرَة	N	---
دَرَّب	V	give_training
سَرَط-ُِ	V	gulp
تَرَيَّث	V	be_late
تِرَنَّح	V	be_swayed
قِلاص	N	glass
تَرَس	V	fill
تَرَنُّح	N	grogginess
تِزَحلَق	V	slip
رَفَسَ	V	kick
فَدو	N	self-sacrifice
تاب	V	repent
خَمر	N	alcohol
شَمَخ	V	bite
ظِفر	N	claw
شَرَخ	V	crack
مَكسُور	ADJ	broken
زَحَف	V	march
لُطف	N	civility
ظُفُر	N	claw
مِرآَة	N	mirror
اِنصَعَق	V	be_thunderstruck
ازرَق	ADJ	blue
زَرقا	ADJ	blue
اَخَفّ	ADJ	lightest
نَقش	N	engraving
شِيفُون	ADJ	chiffon
اَلوان	N	colour
فِيُونكَة	N	complication
حَرّان	ADJ	heated
اِرتاع	V	funk
مُرتَعِب	ADJ	terrified
مِشَمِّخ	ADJ	wet
مِنشِغِل	N	busy
اَنقَذ	V	save
مَرحَبَة	N	hello!
هَلكان	ADJ	tired
نَحاسَة	N	bad_luck
لَحَّ	V	insist
اِحباط	N	thwarting
دافِع	N	motive
بِتِيفُور	N	bagel
مالِح	ADJ	salty
وَزَّع	V	distribute
سَطحِي	ADJ	superficial
رَجِيم	ADJ	damned
مَسمُوع	ADJ	audible
اِنكِماش	N	shrinking
تَشَبَّث	V	cleave
وَهمِيّ	ADJ	bogus
اِنصَعَقَ	V	be_thunderstruck
رَمَش	V	wink
مُواصِل	ADJ	continuing
مِلتِهِي	ADJ	disported
جِبن	N	cowardice
مِرَبَّى	N	jam_preserves
نَعسان	ADJ	drowsy
قِلَّة	N	lack_of
صَبَّ	V	pour
خَلوَة	N	seclusion
مِسَكَّر	ADJ	put_sugar_on
قَلَبَ	V	flip_over
نَشَر	V	be_published
زَهقان	ADJ	dissatisfied
مِتحَمِّل	ADJ	be_able
خاطِب	N	
مَغرِبِيَّة	N	moroccan_cloak
كَكاوِي	ADJ	brown
جِحال	N	kohl
اَهلًا	N	welcome
خَوّاف	N	coward
مُقَرِّر	ADJ	deciding
كَباب	N	kebab_(grilled_meat_dish)
اِنحَسَّن	V	improved
اِثنَينِ	N	monday
مِتخَيِّل	ADJ	imagining
مِعرِّس	ADJ	bride
اوَّل	ADJ	in_the_first_place
مَرسَم	N	ceremony
رابِح	ADJ	winner
واجِب	N	obligation
كَورنفِلِكس	N	cornflex
خاصِرَة	N	waist
فاتُورَة	N	bill
مِزانِيَّة	N	balance
نَقَز-ُِ	V	hop
اِشتِياق	N	yearning
مَقلُوب	ADJ	turned_over
قَدَر-ُِ	V	be_able
مُتَحَضِّر	ADJ	civilized
مُتَفَهِّم	ADJ	reasonable
اَخَبَر	V	tell
قايَس	V	measure
لَهَى	V	have_fun
تَفَحُّصِيّ	ADJ	scanning
مِكَشَّر	ADJ	be_scowl
مُشتَغِل	ADJ	working
عانِس	ADJ	spinster
عَنَّس	V	become_spinster
كَسُول	ADJ	lazy
مِعَرِّس	N	married
خَضَع	V	submit
جَرَّى	V	make_run
تَذَهَّب	V	posh_up_with_gold
تِعَذَّر	V	apologize
مَسكَرَة	N	eyeliner
بُخُور	N	frankincense
صَفَّي	V	squeeze
فَكَّة	N	pocket_money
جَثَى	V	bow_down
زاقَر	V	call
عِصامَة	N	head_cover
ناظِر	ADJ	waiting
طاف	V	swag
اِنحَطّ	V	be_put
اُكسُجِين	N	oxygen
شاعِرِيَّة	N	poetic
اُكسِجِين	N	oxygen
صَبَح	V	start
تَأَزَّم	V	become_worse
نَقَّط	V	speckle
مُخّ	ADJ	brain
تَعَدَّل	V	be_embellished
اِنجَرَف	V	be_swept_away
نَقص	N	loss
دُربَة	N	practice
مَبدَئِيّ	ADJ	fundamental
تَدرِيب	N	training
مُحاكَمَة	N	legal_prosecution
تَحَدَّد	V	be_determined
حَضانَة	N	nurturing
حَدِّد	V	delimit
اِنغَصَب	V	be_forced
ماشِي	ADJ	going
مَودِيل	N	types
كَحيان	ADJ	vulgar
مِنَفَّخ	ADJ	inflate
مُصَمِّم	N	designer
خَبال	ADJ	fantastic
اِتَّصل	V	call
سَهل	N	simply
مُناسَبَة	N	occasion
اِستَفسَر	V	ask
فَخم	ADJ	splendid
اَطعَة	N	piece
فَخامَة	N	excellency
اِستِشارَة	N	consultation
خِدمَة	N	service
لِبنانِي	ADJ	lebanese
خَبِير	ADJ	expert
خَبِير	N	expert
تَجمِيل	N	embellishment
زُبُون	N	client
دائِم	ADJ	always
خُلقَة	N	patience
زَوبَعَة	N	storm
ظَهرَة	N	going_out
قَومَة	N	waking_up
رَكَّب	V	install
كَوشَة	N	the_place_of_bride
صالُون	N	studio
زَحمَة	ADJ	jam
مَكيَج	V	make_makeup
زَبَّطَ	V	repair
اِنحَرَج	V	confused
اَقبَرَ	V	bury
خَجلان	ADJ	shy
مَناكِير	N	manicure
مِنهَدّ	ADJ	broken
تَوفل	N	toefl
مَكياج	N	facial_make-up
مِحَنَّى	ADJ	made_up__with_henna
حِنَّة	N	henna
تِحَنّا	V	make_henna
اَشطَر	ADJ	more_intelligent
اِنتِظار	N	waiting
جَدَّد	V	renew
مُتَهَوِّر	ADJ	vehement
اِجتاز	V	surmount
رادار	N	radar
تِلقائِي	ADJ	automatic
قِياسِي	ADJ	measured
اِتخاشَم	V	kiss
مُحتَلّ	ADJ	occupying
اَرضِيَّة	N	land
عارِي	ADJ	revealing
فَشَل	N	fail
رَأيِ	N	openion
صَفَّر	V	whistle
مُعجَب	N	admirer
طَيّار	N	flyer
اِصتَبَغ	V	be_colored
مَقفُول	ADJ	closed
ماشِي	N	OK
حُرّ	ADJ	independent
بَطَّيخ	N	watermelon
هَبَّب	V	tear
بِشوَيش	N	quietly
تَمَصخَر	V	mock
مِنَبِّه	N	alarm_(clock)
نَهَش	V	tear
عَظمَة	ADJ	bone
اِقتَرَح	V	suggest
مُقاوَمَة	N	opposition
حُمَّى	N	heat
اِستِسلام	N	capitulation
خِلقَة	N	disposition
طارِئَة	N	emergency
مُمَرِّضَة	N	a_nurse
اِبرَة	N	indicator
اَداة	N	instrument
زَرَع	V	plant
مُمَرِّض	N	nurse
قاس	V	be_compared
كِمادَة	N	stupe
سَيرُوم	N	serum
خَطَر	N	threat
وَخزَة	N	prick
اِحتَجّ	V	protest
سائِل	N	questioner
عَمُود	N	pillar
اِسوَدّ	V	be_black
فِيتامِين	N	vitamin
اِستِمرار	N	continuity
دَواء	N	remedy
زِفت	ADJ	crappy
عَرِيس	N	bridegroom
مَقصِد	N	purpose
عارَض	V	reject
طَمّاع	ADJ	greedy
لَذَّة	N	pleasure
مُتَوَفِّر	ADJ	abundant
مِوَزَّع	ADJ	orchestrator
زِرّ	N	button
حَرَّر	V	be_freed
قَول	N	in_word
اَفاد	V	beeful
دُخُول	N	penetration
تَمَّ	V	stay
صَحَّ	V	be_healthy
مُرافِق	N	companion
مُحَلِّل	N	analyst
مُتَفَيِّقَة	ADJ	ready
اَكرَم	V	be_conferred
اِستَرخَى	V	slacken
جَرَّد	V	strip
تَفَحُّصِي	ADJ	investigative
عَمّ	V	be_universal
تَسلِيَة	N	consolation
مِراعِي	ADJ	taking_care_of
لَغَى	V	cancel
اِحتِجاج	N	protest
اِتحَوَّط	V	encircle
جرَّد	N	strip
عَشوائِيَّة	N	randomness
اِتعَشّا	V	have_dinner
اَحمَر	N	red
سُخُونَة	N	heat
مُسَكَّن	ADJ	sedative
فِرِنسِي	ADJ	french
عَجّ	V	full_of
اِنعَدَم	V	be_lacking
اِنعاب	V	be_fault
اِنرَدّ	V	be_refused
شَأن	N	condition
شُور	V	consultation
بَطَّال	ADJ	bad
مُسَمَّى	ADJ	named
دُكتَوراة	N	doctorate
مُحاماة	N	advocating
طَمُوح	ADJ	ambitious
اَصل	ADJ	authentic
اَرعَب	V	terrify
تَحَرُّك	N	activity
مُقابِل	N	cost
دارَى	V	shelter
عَقد	N	concluding
اَنسَى	V	make_forget
خَجَل	V	shame
مُسَبِّب	ADJ	cause
فُوبِيا	N	fear
مُدَوِّي	ADJ	strong
قِطّ	N	cat
قَطُو	N	cat
تَوَجَّع	V	be_in_pain
غَشيان	ADJ	unconscious
مَفزُوع	ADJ	alarmed
شاش	N	muslin
مُتقَن	ADJ	perfect
كارِثَة	N	disaster
اِتعَدَل	V	be_stable
حَرَّم	V	outlaw
رَوَّع	V	frighten
اَوقَف	V	be_made_to_stand
رُصاص	N	bullet
مُشتَرِك	ADJ	participating
مِستَنكِر	ADJ	denying
نَوَى	V	consider
مُحاوَلَة	N	effort
اِنهَزّ	V	be_shaked
اَدخَل	V	make_enter
حَقَد	V	hate
اَذِيَّة	N	harm
رُوتِينِيّ	ADJ	routine
شَتَّت	V	scatter
رَسَب	V	fail
اَصَرّ	V	assert
تَكَتَّف	V	cross_arms
دَهر	N	circumstances
اِتَّخَذ	V	be_adopted
مُزَوِّد	ADJ	increasing
مَرّ	V	go_through
مُتَأَمِّل	ADJ	speculative
تَعَرَّف	V	know
تُفَّاح	N	apple
اِحوَلّ	V	be_cross-eyed
اِلتَصَق	V	affix
قُرآنِي	ADJ	quranic
شَهِق	V	sigh
مَظَلَّة	N	parachutes
مُلحَق	N	attach
تَكَوَّر	V	be_rolled_up
وَرّانِي	ADJ	rear
مِطَلَّع	N	make_go_out
تَأَذَّى	V	be_injured
فَجَّر	V	explode
مِسامِح	ADJ	forgive
مَشَّى	V	make_pass
جُوّا	N	in
اِستَحَي	V	be_ashamed_of
حَلوَى	N	pastry
ذَهَب	ADJ	gold
مُبالَغ	ADJ	exaggerated
قَلَق	N	apprehension
مُتَأَلِّم	ADJ	suffering
مِتوَجِّع	ADJ	suffer
مِنتِبِه	ADJ	alert
كُمدِينا	N	cupboard
اَلبَوم	N	album
خَصَّص	V	allocate
مُراهِق	ADJ	adolescent
فاض	V	overflow
كَثرَة	N	abundance
زيارة	N	visit
مِتغَيِّر	ADJ	alternating
اِبتاع	V	purchase
رَبِيع	N	spring
مَدام	N	madame
لِيدي	N	lady
كَوَى	V	be_pressed
اِتزَهَّب	V	to_be_ready
كَمِل	N	be_concluded
دَقَّ	V	make_precise
خَدَم	N	attendant
لِيش	N	why
بِلَى	N	deterioration
شارِط	ADJ	conditioned
رَزَّة	ADJ	curious
مادَّ	ADJ	extended
جانِب	N	side
خام	N	stinking
طِلِع	V	look
كَذّابَة	ADJ	lier
اَرباب	N	head_of_(house_or_people)
سَفَّر	V	make_travel
سَرَّ	V	pleases
مَدِيم	ADJ	eternal
حَلاًه	N	sweetness
زَود	N	increase
وَقًّف	V	cease
يِمِين	ADJ	right_side
سَمّاعَة	N	telephone_receiver
صَدَّى	V	echo
طالعَة	N	beginning
كِشُوخِي	ADJ	showing_off
اَكشَخ	ADJ	showing_off
فاسِد	ADJ	corrupt
طاق	V	be_able
هَذَب	V	prune
حَلُو	V	be_sweet
صُعلُوك	N	vagrant
مِلَوَّك	N	king
طَرّ	ADJ	beautiful
لاعِب	ADJ	playing
تَنُّورة	N	skirt
كَستَنائِيّ	ADJ	maroon
رِجِيم	N	diet_(fr._rgime)
هِرم	ADJ	damned
طايِق	ADJ	standing
طايق	ADJ	standing
بارتِي	N	party
رَقص	N	dancing
اَطوَلَ	ADJ	taller
مُطَوِّع	N	mutawwa_(religious_police)
هَزر	N	guess
تَجمِيعي	ADJ	joining
حَنين	N	nostalgia
صَوتِي	ADJ	vocal
كَيس	N	cleverness
دَوبِي	N	laundryman
مَغَلَطَة	ADJ	erring
حَجِيه	N	حجيه
دَخل	N	income
هِندِي	N	indian
تِآمَر	V	co-conspire
تِنافَض	V	beat_the_dust_from
بَلّان	V	matter
مِدِّي	N	donor
مِوَدِّي	N	make_go
بِرِنس	N	princes
ابي	V	want
مَلِيء	ADJ	filled
نَكس	N	walking
مِتوَهِّق	ADJ	entangled
بَلشَة	N	misfortunes
قُذام	N	in_front_of
دَقّ	N	pulverization
سَيِّدَة	N	mrs.
مَقفَل	ADJ	blocked
نَشِط	V	be_energetic
هَلَكان	ADJ	disaster
سَيَّر	V	dispatch
شاور	N	shawer
وِزار	N	short
فانِلَّة	N	t-shirt
بِرَيكفاست	N	breakfast
فَوّال	N	beans_vendor
مُجابِه	N	opposite
مِتلَحَّف	ADJ	be_wrapped
شايفَة	ADJ	onlooker
حازِم	ADJ	resolute
هِرم	N	damned
تَعذِيب	N	torture
وَنّة	N	moaning
تَحَنحَن	V	be_implored
ظَلَم	V	oppress
شان	N	condition
هامّ	V	interest
تَكَدَّر	V	be_disturbed
تضايَق	V	annoy
باغِض	ADJ	hating
تبَيَّن	V	know
هَنِيء	ADJ	beneficial
هَجر	N	emigration
شَرَّع	V	legislate
شَرار	ADJ	emitting_sparks
عَمرَة	N	life
اًَمان	N	safety
كِبرياء	N	glory
حاسِّس	V	feeling
مِناقِر	ADJ	dispute
لِحيَة	N	beard
ناقَر	V	quarrel_with
غايَض	V	irritate
مَزيُون	N	pretty
ماصخَة	ADJ	stupid
لُعّاب	ADJ	flirtatious
جَربُوع	N	jerboa
يَربُوع	N	jerboa
صَفَرد	N	partridge
مِناقِر	N	scrapped
مَدِيم	N	eternal
سَبالَة	N	peanut
نَهَى	V	be_informed
اَحسَن	V	be_proficient
اِندَفَع	V	be_paid
خَذَل	V	abandon
اِنخَدَع	V	be_deceived
لَقى	V	receiving
مَلَخ	V	tear_out
مِطَوَّر	ADJ	developing
مِحَرَّف	ADJ	distorting
فايِد	N	need
سِيرَة	N	epic
تَعَرُّف	V	acquaintance
خاس	V	break
مُول	N	at_all
غَرشوبَة	ADJ	beautiful_girl
غالِي	N	precious
مِغلِي	N	productive
دِلخ	N	imbecile
عُودَة	ADJ	adult
مادَّ	N	extended
تَأَوُّه	N	sigh
مُشِين	ADJ	horrible
مُحاضرَة	N	lecture
اَسكَت	V	mute
غَنِي	V	become_rich
نَظّار	N	spectator
كاشِخ	ADJ	showing_off
تَحَرِّي	N	inquiry
فَرَض	V	impose
شَبَه	V	compare
اَغنَى	V	satisfy
صارُوخ	N	quick
جَذّاب	N	alluring
فاطِس	ADJ	dead
اِستَلعَن	V	get_cursed
تَوَقُّع	N	anticipation
شاهِد	N	witness
مَنام	N	sleep
هَيام	N	passion
اَهَمّ	V	be_important
اعدام	N	execution
اِشتَعَل	V	catch_fire
حَرِيقَة	N	fire
عام	N	year
لُجّ	N	depth
غَرِيق	ADJ	immersed
عَوّام	ADJ	expert_at_swimming
سَلَب	V	deny
حِسّ	N	sound
رُهَيِّف	ADJ	delicate
جَدِيلَة	N	lock_of_hair
مَتن	N	surface
طَلِيق	ADJ	free
هَبُوب	N	blowing
نَسَم	N	breath
بَرِيق	N	glitter
رَمَى	V	throw
لَحظ	N	glance
سَهم	N	arrow
وِداد	N	friendship
عَشِيق	ADJ	lover
جارِي	ADJ	current
شِريان	N	artery
مَغرَم	N	love
جَفّ	V	become_dry
مِدرِك	ADJ	aware
فُوطَة	N	napkin
مَبلُول	ADJ	wet
لَفَّة	N	round
دَعَّم	V	strengthen
صَدَّة	N	a_block
وَلِه-َِ	V	become_insane
مِسَبَّح	ADJ	bather
احراج	N	embarrassing
حارَة	ADJ	hot
مَحمُوم	ADJ	feverish
صاير	ADJ	became
حَمرا	ADJ	red
جِنِّي	N	jan
كَفّ	V	refrain
رَزِين	ADJ	calm
مِتبادِل	ADJ	mutual
دام	N	as_long_as
خايِب	ADJ	disappointed
عَرقُوب	N	dune_of_sand
حَزّ	V	cut
مَقسُوم	ADJ	divided
بَوش	N	camel
عُرقُوب	N	achilles_tendons
مَجهُود	N	endeavors
مَلَأ	N	audience
مَصيُود	ADJ	fishing
مُصاب	ADJ	injured
قَوام	N	proper_condition
عُود	N	lutes
ضامّ	ADJ	joining
مِتَّيِّم	ADJ	lovelorn
وَصل	N	limb
حَسُود	ADJ	envious
عَهد	N	authorization
مُوَثَّق	ADJ	sure
مَفنُود	ADJ	discerning
غايَة	N	goal
حِنّ	N	nostalgia
ضامّ	N	conjunctive
سُعُود	N	good_luck
ناقَة	N	she-camel
تَوصِيف	N	characteristic
ذِيل	N	tail
نُخاع	N	spinal_cord
رُفَيَّع	ADJ	delicate
غارِب	N	ridges
رَكِيب	N	passenger
فَج	N	depth
شَعفَة	N	summit
جَلّ	V	be_majestic
مِمتِلِي	ADJ	replete
نَحر	N	slaughtering
زَور	N	throat
خُفّ	N	sole
واسِع	N	extensive
طَقم	N	set
تَقوِيم	N	calendar
اَقدَر	ADJ	most_capable
سَوَّي	V	do
هَبَل	N	stupidity
تَراكَض	V	compete
خَدّامَة	N	servant
شافِن	V	see
مِجَبِّس	ADJ	casted
فُلَّة	N	a_jasmine
اَسخَف	ADJ	most_tedious_illy
رَوق	N	horn
لاحّ	ADJ	narrow
خَفِي	V	be_hidden
جارِحَة	N	predatory
اِستَباح	V	allow
غَيم	N	cloud
قَصِيد	N	gist
ناح	V	mourn
اَدرَى	V	be_informed
حار	V	recede
بَرَّق	V	shine
بَرّاق	N	flashing
وَنَّة	N	moaning
تَلاحَى	V	exchange_insults
تَشافى	V	heal
زاد	N	provision
زاح	V	depart
سَجَّى	V	shroud
قَفاً	N	back
تَناحَى	V	move_away
هان	ADJ	be_contemptible
بِكا	N	crying
شِلو	N	limb
سَدّ	N	dam
باح	V	divulge
تَدانَى	V	get_closer
مُعافى	N	intact
شاحّ	V	withhold
نار	ADJ	burning
عَذل	N	censure
كِبرِيت	N	match
بَدَن	N	body
سَلِس	N	flexible
عَذَل	V	censure
تايِب	ADJ	repentant
اَطاق	V	endure
مَضنُون	N	stressed
اُنشُودَة	N	song
اَوقَد	V	ignite
هال	V	intimidate
لَهِيب	N	flame
دَوّار	ADJ	rotating
مِتشَربِك	ADJ	interwoven
نايِب	N	delegate
سارِي	ADJ	valid
عاذِل	N	censuring
صايِب	ADJ	disaster
عايِب	ADJ	wretched
كَرَم	N	generosity
جُود	N	generosity
مِسك	N	musk
جاذِب	ADJ	alluring
زاهِي	ADJ	resplendent
شِفاء	N	remedy
اَعذَب	ADJ	sweeter
طَبيب	N	doctor
حاز	V	possess
طايِب	ADJ	mature
صَحّ	V	be_correct
واخِذ	ADJ	engrossing
اِهتَدَى	V	be_led
نَسَى	V	forget
جِبِين	N	brow
حِشمَة	N	timidity
مَنزَل	N	next
رَعَى	V	sponsor
صام	V	fast
حامِي	ADJ	patron
مَحِيَ	V	be_wiped
وِصال	N	communion
وَهم	N	delusion
جَنَى	V	harvest
عَرَبِيّ	N	arab
بَلِي	V	deteriorate
اَسرَف	V	be_excessive
زُبد	N	butter
اِستَخار	V	seek_guidance
عَصَى	V	refuse
بايِع	ADJ	seller_alesman
سوَّام	ADJ	haggler
مِقدام	ADJ	courageous
رَجا	N	please
رَجِي	V	remain_silent
سَجِين	ADJ	prisoner
اِفراج	N	release
اِعدام	N	execution
مَحصُول	N	result
اِلهام	N	inspiration
صِيت	N	renown
قَدَم	N	foot
مَحنِيّ	ADJ	bowed
اِبهام	N	incomprehensibility
أَكَّل	V	feed
قَرُب	V	approach
مِغَلِّي	ADJ	made_expensive
تَعالَى	V	let's
عَشِي	V	be_night-blind
دَعنَة	N	earth
هَنا	N	happiness
ياء	N	y_letter_in_arabic
حَمراء	ADJ	red
زِند	N	antebrachium
صان	V	maintain
صَخَر	N	rock
حِنِّية	N	love
مِتَنَّح	ADJ	frowning
خَشَّع	V	tremble
تَخشِيع	N	trembling
واح	V	follow
مُحاضَرَة	N	lecture
عايب	V	scoff_at
هاي	N	hi
بِرَذَرـ	N	brother
اَشَر	V	cut_with_a_saw
تَغَمشَر	V	jest_with
جا	ADJ	come
كَرّ	N	recurrence
بَدَوِيّ	N	aim
شابَّة	N	young_women
اتَّريَق	V	ridicule
سَكتَة	N	calm
مِتلَوَّم	ADJ	shy
خَلفِيَّة	ADJ	rear
كُرسِي	ADJ	seat
اَعقَل	ADJ	more_reasonable
اَشبَه	V	look_like
مَليان	ADJ	full
زَوال	N	demise
اَرضِيّ	V	grind
تِغَشمَر	V	jest_with
مُتَوَقَّع	ADJ	expected
لَهَّى	V	amuse
هَمَز	V	prick
خَطِير	ADJ	grave
وَرِم	V	become_swollen
مَرهَم	N	salves
صَيدَلِيَّة	N	pharmacy
مَسمُوح	ADJ	permitted
سَلسَلَة	N	sequence
طَعن	N	stabbing
غادِر	ADJ	perfidious
تَصرِيح	N	license
لَدَغَة	N	sting
حَنَش	N	snake
مَدفُون	ADJ	hidden
مُحادَثَة	N	negotiation
بايَع	ADJ	seller_alesman
شَرَف	N	distinction
رَمَّس	V	speak
مِرَصَّص	ADJ	adorned
مَعهَد	N	institutes
مِصيَدَة	N	trap
اُنثَى	N	testicles
خَمَّة	N	stench
مِتصِنِع	ADJ	be_built_egy_تصنع_ما_verb_:_i2ms_part_neg\t_صَنَع_fabricate
اَلِّت	V	make_fun
اَخلَى	V	allow
حَيَّة	N	snake
اَخلَف	V	break
توَلَّى	V	seize_control_of
عَشَى	N	dinner
مِشتِهِي	N	coveted
اخبَر	V	tell
شَفاة	N	lip
حِشام	N	modesty
اَشقَح	V	distance
نَطَح	V	butt
تَيس	N	fool
بَعدَين	N	then
هَيمان	ADJ	thirsty
مِطَلَّع	ADJ	show
اَقسَى	ADJ	cruelest
قَسوَة	N	severity
خَدَع	V	deceive
كُلِن	N	all
اَغلَى	V	raise_(price)
بايِخ	ADJ	an_importunate_pest
اَفتَر	V	mitigate
مِتخَشَّع	ADJ	afraid
شَرار	N	spark
بَدى	V	start
دَلُّوع	N	pampered
تقَرَّب	V	approximate
تَسَمَّى	V	be_called
اَهان	V	be_disdained
بِرِنسِس	N	princes
عَطن	V	give
ضايِق	ADJ	annoyed
حاصِل	N	result
اَهلِيّ	ADJ	domestic
تَصَنَّع	V	simulate
مَصلَحجِي	ADJ	selfish
تَصَلَّح	V	repair
نَسرَة	N	chip
مُسرِع	ADJ	hastily
مِرَمِّس	ADJ	taking
شُهرَة	N	reputation
بايَع	V	sell
اَقسَم	V	take_an_oath
لُوث	N	dirt
سَوِي	V	deserve
شُرطِيّ	N	police_officer
جُثَّة	N	corpse
تَناوَل	V	take
اَشال	V	lift
وَهِي	V	be_frail
انمَسَحَت	V	be_removed
ماذا	N	what
بَشَر	N	mankind
دَمّ	N	dye
اِنهَدّ	V	destroy
مِثَلِّج	ADJ	frozen
غَناة	N	precious
طَلَق	V	divorce
واحَة	N	oasis
شِمِت	V	gloat
رَخُص	V	be_cheap
طالِق	ADJ	divorced
مَهمُوم	ADJ	preoccupied
اِشتَكى	V	complain
رَصِيف	N	sidewalk
جَلّاسة	N	chair
حَقِير	N	despised
مَقهُور	ADJ	humiliated
حِنطاوِي	ADJ	tanned
رِياضِي	ADJ	sportive
كَشِيخ	ADJ	showing_off
كَشَخ	V	show_off
مُوصِي	ADJ	testator
اَبدَى	V	show
لَعنَة	N	curse
خَنقة	N	suppression
مَرَدّ	N	underlying_factor
مِدواخ	N	tobacco_pipe
راع	V	startle
ساس	N	bottom
دَفِين	ADJ	hidden
نَوح	N	mourning
هايِج	ADJ	agitated
عِنايَة	N	attention
اَحمَر	ADJ	red
اِدَّعَى	V	allege
اِنتَشَر	V	be_anN
سَيِّئ	ADJ	bad
سُوء	ADJ	miss-
تَعافَى	V	recover
مَسؤُل	N	responsible
بَدِيل	ADJ	alternate
انطَلَع	V	take_out
شُور	N	openion
بالَى	V	be_cared_for
مَرفُوق	ADJ	accompanied
عاتَب	V	reprove
مَحسُوم	ADJ	concluded
وافِي	ADJ	abundant
جَرَى	V	happen
صَفَى	V	liquidate
غَرّ	V	mislead
حَجزَة	N	reserving
سَفَر	V	unveil
مَخبَأ	N	hide-out
هَيَّاته	N	loitering
رِكِيض	ADJ	running
تَدَّخَل	V	tamper
خَزَّن	V	hoar
باتّ	V	remain
عَقَل	V	be_conceivable
اَذِّن	V	call_prayer
كافَيه	N	café
بَسكُوتَة	N	cokies
لَيت	N	lamp
مُشَغَّل	ADJ	working
حَرامِيّ	N	thief
تُجاه	N	toward
قَبلِي	ADJ	previous
صِبِح	V	be
كافِي	N	coffe
لَقِي	V	meet
دَمَع	V	cry_tears
خَطف	V	go_quickly
صَبُور	ADJ	tolerant
كاتِم	N	silencer
مِحتَدّ	ADJ	angry
اَعيَى	V	thwart
تَفَهَّم	V	comprehend
مُعَذَّب	ADJ	tortured
طَور	N	mountain
مُؤَبَّد	ADJ	life-long
نَفَذ	V	pass_through
بَعَد	V	go_far
جَهوَرِيّ	ADJ	loud
اَهدَى	V	give_a_present
جوري	N	damask
مَروَى	N	marwa
اشتاط	V	be_irritated
صَدَقَة	N	charity
سَمّ	N	poison
تَحايَز	V	defend
هَذرِيَّة	N	talking
اِتحَرطَم	V	get_broken
طَلِيق	N	x-husband
عِيارَة	N	underhanded_dealing
تَحَمَّل	V	assume
عَقَّم	V	tie
عَقِيم	N	unproductive
مِأدِب	N	educated
سُوات	N	family
رَصّ	N	arrangement
مِزاعِق	N	angry_bluster
دَلخ	N	imbecile
جَرادَة	N	locust
سب	V	flow
اَذَّى	ADJ	offensive
ثَوَّر	V	revolutionize
تَذكِير	N	reminder
دارِس	ADJ	studying
اِنتَحَر	V	commit_suicide
تَجَهِّز	V	prepare
عَيّارَة	N	ridicule
تَبارَك	V	be_blessed
خَلّى	V	allow
خَطَّط	V	make_plans
تَلاقى	V	meet
حَسِّس	V	make_feel
مِخَبِّل	ADJ	insane
عَجوز	N	old_person
سائِر	ADJ	current
تَخطِيط	N	planning
مِتفاهِم	ADJ	understanding
كانِن	V	be
خَطرَف	V	be_delirious
مَطُول	ADJ	procrastinating
لَبّى	V	be_carried_out
فارِق	N	differences
فِنجان	N	coffee_cup
مَشرُوب	N	beverage
فِكر	N	thought
مُهجَة	N	core
مِتهَنِّي	ADJ	happy
مِتبادِي	ADJ	appeared
بادِي	N	obvious
مَحَن	V	examine
اَفقَد	V	make_lose
مُراد	N	desiratum
ناجَى	V	confide_in
هامَة	N	head
مَديُون	ADJ	indebted
مِتجَنِّي	ADJ	committed
مِستِحِلّ	N	considered_halal
غادِي	N	coming
فَنّ	N	art
حَذِر	V	beware
هَيِّن	ADJ	easy
مُصَوَّر	ADJ	photographed
رَدِي	V	perish
رَطَّخ	V	be_fallen
مِتخَرِّس	ADJ	dumb
مِنطَقَة	N	area
مِتنَدِّم	ADJ	repenting
وَظِيفَة	N	function
حابِِس	ADJ	confined
وارِد	N	newcomer
مَعذِرَة	N	excuse
اَعذَر	V	excuse
مُنتَزَه	N	recreation_ground
اِرادَة	N	desire
سَحاب	N	cloud
مُتَّجِه	ADJ	directed
واقِف	N	standing
تَيَدَّد	V	perform_ablutions
مَعثُور	ADJ	difficult
دَولَة	N	country
مِضَيَّع	ADJ	squandering
مِأَثَّر	ADJ	influential
جِنّ	N	demon
هَمَز-ُِ	V	prick
خِيرَة	N	elite
نَقِذ	V	be_rescued
مَحَبَّة	N	love
تَوبَة	N	penance
سَوّى	V	do
ساجِد	ADJ	worshipper
مَعصُوم	ADJ	inviolable
اِرتاح	N	rest
بَياض	N	whiteness
بُغيَة	N	wish
حَلِيلَة	N	wife
تَمادَى	V	persevere
كَيل	N	dry_measure
بَريّ	ADJ	innocent
مَصاب	N	injured
تَواصُل	N	continuity
سَوِي	N	together
نَهج	N	pursuing
عُسر	N	difficulty
لِين	N	flexibility
مُفتَنِد	ADJ	inspector
رَمَش	N	conjunctivitis
تاه	V	go_astray
مُولَع	ADJ	passionate
لَظى	ADJ	burning
غَضَى	N	unbearable_situation
سالِي	ADJ	absentminded
راعِي	V	show_deference
مَطُول	N	procrastinating
مُسَوَّدَة	N	black
خَلَق	N	threadbare
سُوَيج	N	car_keys
زايد	ADJ	exceeding
مِعطِي	ADJ	given
عِلج	N	gum
تَرى	V	by_the_way
حان	N	arrive
مِستَلغِث	ADJ	in_a_hurry
مَسخَر	V	deride
اَسار	V	be_dispatched
طاب	V	be_good
ناسِب	V	fit
رَحب	ADJ	spacious
نُون	N	nun_(arabic_letter)
تغَيِّر	V	change
حَبل	N	cord
عَيِي	V	be_incapable
وافِق	V	concur
اخَذ	V	blame
مُضارِب	N	speculator
غَلَّس	V	annoy
زَبِيب	N	raisin
طايح	ADJ	falling
زَقَر	N	call
حَمال	N	pregnancy
باعِد	V	away
حَلَى	V	be_embellished
عاملَة	N	activity
استخار	V	seek_guidance
اَخبَر	V	tell
فايق	ADJ	good
صَطَع	V	be_hit
طُمُوح	N	craving
مِصَمِّم	N	designer
كَرف	N	house_chores
حَوي	N	courtyard
مَفرُوش	ADJ	furnished
زَوليَّة	N	worshiper
كِوار	N	the_metalic_boxed_grill_that_you_light_charcoal_in
جَذّاب	ADJ	alluring
مِرَمِّس	V	talk
مَرَق	V	be_hit
غَلُو	N	ghalou
اَكادِيمِي	N	academy
اِستار	N	star
اَكادِمَي	N	academy
رَوَّى	V	show
تُونِسِي	ADJ	tunisian
تِصاصَر	V	mutter
حُوَيِر	N	small_camel
شاوَر	N	shower
قايِلَة	N	midday_nap
ناخَر	V	snore
ناشّ	N	vigilant
وِقايَة	N	headcloth
اِبرِيق	N	pitcher
حَلُول	N	herbal_medicinal_mix
مَزر	V	sip
تِجَغَّم	V	gulp
عالَم	V	find_out
زِرِيبَة	N	stockade
رَجاء	N	please
طِحِين	N	flour
اِكَّحَّل	V	paint_with_kohl
ضَجّ	N	droning
تِعَدَّل	V	flourish
بَودرَة	N	powder
بِلَشَر	N	plusher
خَقَّاق	ADJ	deceived
رِضاء	N	acceptance
اَبيَضانِي	ADJ	white
مُلفِت	ADJ	attracting
اِترَيَّق	V	eat
غاصِب	ADJ	compelled
قَمَّز	V	take_with_the_fingertips
مَتِين	N	chubby
ماء	N	water
دَفاشَة	N	intensity
شَرَق	V	choke
فِتك	N	jeep_(vetc)
لِحف	N	cover
واقِع	ADJ	falling
رُطَب	N	ripe_date
رُوَيحَة	N	going
خانَة	N	role
مِطَبَّة	N	bump
فَزَّة	N	startled_jump
خَوَّز	V	take
اَمام	N	forward
بُوش	N	camel
طَرش	N	sprinkling
مِبّرَّد	ADJ	water_coler
جارّ	ADJ	draging
مِصباح	N	light
ناطّط	V	jump
شَرق	N	east
غَرب	N	westward
مِأَذِّي	N	hurting
حَرَج	V	be_oppressed
زَيَّق	V	bother
نَخل	N	palm
تَلقِيط	N	gathering
سَلَّة	N	basket
بَيذام	N	almond
شَجَر	N	tree
ذِبّانَة	N	arm
تِحَلَّم	V	dream
زِطِّي	ADJ	miser
طَرَح	V	drop
بَيذامَة	N	almond
مِتنَرفِز	ADJ	fanatical
تِلَذَّذ	V	be_pleased
حَرّ	N	heat
اَخيَس	ADJ	more_bad
رِمَونت	N	remote_control
اِتحَرَّى	V	pursue
مِتفزِّر	ADJ	inflexible
نَطّ	V	leap
مَرعُوب	ADJ	terrified
مُوَرَّم	ADJ	swollen
قُطن	N	cotton
وَرَم	N	tumor
رِبعان	N	running
بُرطُم	N	lip
فِري	ADJ	free
بَطّ	N	duck
غَزّ	N	cheek
مِنشِغِل	ADJ	busy
تَصَدَّد	V	deter
اِمبِين	N	among
مِبَوِّز	N	sullen
مِدَوَّخ	ADJ	conquering
والِي	N	ruler
مُصَلَّى	N	prayer_mat
تِيَدَّد	V	perform_ablutions
تِحَمَّل	N	bearing
قَيلُولَة	N	midday_nap
فايِق	ADJ	boundless
اِدَّرَّس	V	study
دَفَّر	V	push_back
مِقابِل	V	in_front_of
تَرَجِّي	N	request
كابَتشِينُو	N	cappuccino
مِتنَفرِز	ADJ	fanatical
مِكَشِّر	ADJ	frowning
تِناقَض	V	uprise
طاف	N	taugh
زَيغَة	N	fright
مِتأَدِّب	ADJ	courteous
عَجرَفَة	N	arrogance
تَنَفُّس	N	respiration
اِنتَظَم	V	be_organized
زُوليَّة	N	carpeting, carpet
اِتمَسَّح	V	perform_ablutions
صَرَخ	N	scream
شاهَق	V	sigh
تِهَزَّز	V	be_shaken
قَصّ	N	clipping
شِبر	N	foot
اِنَّ	N	that
لَزَم	V	ne
عاجِب	N	liking
لَوَّى	V	gurgle
مُقاطعَة	N	district
اِنفَجَّ	V	be_pushed
وِراثَة	N	genetic
مِحَنِّي	N	put_henna
قَرقَط	V	make_laugh
اِنقَفَط	V	be_arrested
بَنُّوتَة	N	girl
غُمَّة	N	anxiety
اوَّل	ADJ	first-place
حاس	N	extend
كِرَش	N	crash
اِتطَنَّز	V	deride
هارد	N	hard
طايِع	ADJ	aware
دِرام	N	garbage
سَب	V	curse
اَعطِي	V	be_given
عافِد	ADJ	jumping
تَوب	N	top
اِتطَّلَّع	V	examine
دِراما	N	drama
تَرجَم	V	translate
عَنزُوه	N	goat
كُورِي	N	korean
اِتشاوَف	V	see
جِيَّة	N	coming
اِطَّنَّز	V	deride
تَأَفَّف	V	grumble
شَيطانِي	ADJ	devilish
بارِض	N	mood
بَحلَق	V	gaze
مَحلَى	N	candy
عُمق	N	depth
عَجِينَة	N	paste
بُفّ	N	puff
بَغَّم	V	summon
هَزَّر	V	make_fun
تَفتِف	V	saliva
بَرَّد	V	make_cold
اَحَدّ	N	sunday
بَوزَة	N	be_glum
وَتَّر	V	strain
مَزخُوخ	ADJ	taken
جُرم	N	sin
تِخَصَّر	V	put_the_hand_on_the_waist
ذَين	N	ear
-اَخبَل	ADJ	insane
خَبَّل	V	complicate
تَحَنَّن	V	hem
عَدِيل	ADJ	sister_in_low
راي	N	think
اِبن	N	son
كَذُوب	ADJ	liar
مِنخِفِض	ADJ	low
اِنقَصّ	V	laughed_at
مَنظَرَة	N	woman
تَعدِيل	N	amendment
تِكَحَّل	V	paint_with_kohl
قِلَوس	N	rouge
جَلّابِيَّة	N	gallabiya_(gown)
صَفوَة	N	headcloth
تَقلِيب	N	transformation
صَمَّخ	V	deafen
بَغِيم	N	angry_bluster
طَفر	N	eye_side
زَغَر	V	summon
حالِف	ADJ	swearing
قِدّامِي	ADJ	frontal
حايِس	ADJ	creeping
قَلَّل	V	reduce
زَوَّد	V	add
مُزَوِّدَة	ADJ	providing
لِ	N	for
مَغازِلجِي	ADJ	dallying
حُرِّيَّة	N	freedom
لَوى	V	be_bent
مُقرِف	ADJ	disgusting
شاف	ADJ	see
رَواح	N	same
رَمل	N	sand
مِستَعجِب	ADJ	amazed
تِصَنَّع	N	dissimulation
تَمثِيل	N	exemplification
كَلش	N	clutch
قَير	N	transmission
هِستِيرِي	ADJ	hysterical
فَوَّل	V	scream
طَرقَة	N	knock
خَبلَة	ADJ	insane
كَشَّر	V	scowl
سُكُوت	ADJ	calm
جَذَّاب	N	alluring
مِلَوِّع	ADJ	tormenting
سِمَك	N	disgusting
اِدَّلَّع	V	pamper
مَلَّان	ADJ	dissatisfied
لِستَة	N	pillar
تَمَلمُل	N	grumbling
سَوَّاق	N	driver
مازِر	ADJ	filling
بَطَّل	N	open
بِقالَة	N	grocery
فِتامِين	N	vitamine
سِي	N	c.
كَبس	N	kabsa
اَيِس	V	ice
مِنقِلِب	ADJ	overthrowing
تِلَخبَط	V	be_confused
اِزرَقّ	V	be_blue_in_color
اِصفَرّ	V	become_pale
عَنِيف	ADJ	violent
تَرَوَّع	V	dismay
مَلهَى	N	amusement_centers
فِيس	N	face
تِوَهَّم	V	be_persuaded
فِلس	N	fils_(small_coin)
فَلَّس	V	declare_bankrupt
تِضحَّك	V	be_laughed
غِنَى	N	wealth
مُنفَصِل	ADJ	detached
مُنعَزِل	ADJ	sporadic
زِياغ	N	deviation
دايِر	ADJ	conquering
تَهاوَع	V	collapse
تِهاوَع	V	collapse
نَصّ	N	ext
مَحذُوف	ADJ	deleted
تِقَيَّأ	V	vomit
مَكرُوه	N	unforeseen_event
حاكى	V	narrate
حالِج	N	condition
قِرطاس	N	paper
قَرشَة	N	glass
كِبِير	N	senior
سابِق	V	race_against
مِنكِمِش	ADJ	preoccupied
ضَجَر	N	dissatisfaction
حامَل	N	pregnant
مُقَدَّم	ADJ	submitted
نَرفَزَة	N	making_nervous_or_angry
زَعتَر	N	wild_thyme
مَلح	V	salt
لَوع	N	sickness
دُورَة	N	dizziness
تَقَيَّأ	V	devout
مُتعَب	ADJ	weary
اِرتِجاف	N	tremor
اخ	N	brother
نَشِيط	N	energetic
كَبّ	N	shed
بَلُّوعَة	N	word_in_the_genitive_case
سِباق	N	race
صَقَع	V	strike
تَقَرقِيط	N	tickle
تَنقِير	N	reprimand
اِستَراح	V	rest
مِتضَيِّق	ADJ	annoyed
نَكهَة	N	breath
كاكَو	N	cacao
دِيفِيدِي	N	dvd
مِشَحَّط	ADJ	hoarse
مُمَوَّج	ADJ	curled
مَهل	N	leisurely
خِشِن	ADJ	rough
اِندَسّ	V	conceal
كَهرَباء	N	electricity
غَرشُوب	N	pretty_girl
طَرنَبَة	N	trumpet
مَطبُوخ	ADJ	cooked
تَغسِيل	N	washing
تَشغِيل	N	activating
غاز	N	gas
فَتح	N	opening
قَلَى	V	bake
بِيضَة	N	egg
اِستِوعاب	N	consciousness
مُتَدَخِّل	ADJ	curious
عَزَّ	V	be_reinforced
عَرِق	V	perspire
عَرقان	ADJ	perspiring
بايِن	N	clear
نِصفانِي	ADJ	located_in_the_middle
نُعاس	N	sleepiness
تِمتَح	V	swing
شَبَح	N	shape
كَسلان	ADJ	lazy
فِضِّي	ADJ	silver
اَيلَينَر	N	eye_linear
اِرتِياح	N	pleasure
اِنزَخَر	V	be_hit
دِرامِي	ADJ	theatrical
مِقتِنع	ADJ	convinced
بَلاهَة	N	stupidity
عَدَل	V	adjust
نَفاف	N	beginning_of_the_rain
مُلاحَظَة	N	note
زُحلَيقَة	N	chute
زَحلاقَة	N	chute
ثَلج	N	snow
جِنز	N	jeans
طاقِيَّة	N	cap
مَعهُود	ADJ	well-known
بَنَّد	N	close
رَشاقَة	N	shapeliness
كَندُور	N	shirt
شَلَح	V	divest
قَلَّص	V	shrink
دِار	V	turn
لَوَّح	V	insinuate
فَوقِي	ADJ	super-
تَضارَب	V	clash
اَنشَد	V	inquire
بَيج	ADJ	beige
تِفَيرَز	V	freeze
تِلاعَب	V	mock
غَشَّاش	ADJ	deceptive
غَشّ	V	tamper
مِجَلِّس	N	making_sit
لامَس	V	touch
صَوبَع	N	finger
خادِم	ADJ	assisting
شِتوِي	ADJ	wintery
اِنفَهَم	V	be_understood
هادّ	V	intimidate
تَطنِيز	N	ridicule
حالِم	ADJ	dreaming
مِنَوِّر	N	turnning_on
طِبّ	V	leave
غَيمَة	N	cloud
اِقتَرَب	V	get_close_to
مَكشُوف	ADJ	egregious
لَزقَة	ADJ	sticky
مُنبَطِح	ADJ	prostrate
مِنفِزِع	ADJ	alarmed
جِنِّيّ	N	fairy
تَلَثَّم	V	be_covered
خَرَّط	V	lie
رِجَّال	N	antenna
طَبل	N	drum
حَلات	N	sweetness
تِحَرَّط	V	voice
تَطنِيش	N	disregarding
اِندِماج	N	harmony
صاد	V	hunt
ذَهَب	N	gold
مِجَوهَر	N	jewelry
مِتأَفِّف	ADJ	grumbling
اِستِفهام	N	question
خلَّى	V	maintain
تِسَلَّل	V	infiltrate
نَشَل	V	let_drop
طِين	N	clay
مِتجَمِّد	ADJ	firm
هالَة	N	nimbus
سادة	ADJ	okay
حَلَف-	V	take_an_oath
عَشَر	ADJ	ten
ضارِبَة	N	quarrel
خَرطَف	V	trip_up
قِفل	N	lock
اِختَلّ	V	malfunction
مَمدُود	ADJ	extensive
اِتسَحَت	V	perish
مُستَنِد	ADJ	depending
وادِي	N	wadi
حابِس	ADJ	obstructing
مَغسَل	N	reservoir
غَبرَة	N	passing
نازِل	N	staying
مُطَنِّز	ADJ	scoffing
رُكُوب	N	mounting
سَندوَيش	N	sandwich
دَقُّوس	N	chili_pepper
مِندَسّ	ADJ	hidden
اِتجَرَّأ	V	risk
عَظمِي	ADJ	osseous
اِنبان	V	appear
مِرَبرَب	ADJ	corpulent
وَدَع	V	allow
فَرَّج	V	separate
جاء	V	arrive
مِنصاب	ADJ	injured
اَغلَق	V	lock_or_bolt_shut
سَلِي	V	get_rid_of
رَجَى	V	hoped_for
مِنساب	ADJ	be_flowed
عَطَي	V	give
قَسَى	V	do_wrong
وَفا	N	trustfulness
مِتعاب	N	fatigue
مَنقُول	ADJ	transferred
مَعَرَّس	ADJ	married
خِرِّيج	ADJ	graduate
سِياسِيّ	ADJ	political
مِشَفَّر	ADJ	encrypted
مُصَرَّح	ADJ	licensed
مِحَوِّل	ADJ	converting
تَساهَل	V	be_indulgent
مُوَفَّق	ADJ	successful
خَدَّر	V	make_numb
حارِس	N	guard
مُشَدَّد	ADJ	strengthening
اِستَحيَى	V	let_live
مُغامَرَة	N	debate
تَسَبَّح	V	take_shower
اِفتَكَرَ	V	remember
شَعبِيَّة	N	district
واعَد	V	arrange_aeting_with
تَبادَل	V	trade
رابَع	V	run
دَبَّس	V	stick
اِلَٰه	N	deity
اِلِكتِرُونِيَّة	N	electronic
رِياضِيّ	ADJ	sportive
مَشّايَة	N	walk_machine
اِنلَبَس	V	be_dressed
مَمشَى	N	corridor
اَيَّد	V	support
نَقَّى	V	select
رِياضَة	N	physical_exercise
زِلَيغ	N	sock
نَوعِيَّة	N	peculiar_quality
غالِيرِيّ	N	gallery
عُطُورَة	N	perfume
شَمَّم	V	sniff
بَحث	N	search
قَبِل	V	accept
مُوَلَّع	ADJ	shining
صِنِيَّة	N	---
حجاج	N	eyebrow
حَسِب	V	regard
نَحس	ADJ	ill-fated
هَيصَة	N	tumult
مُتَزَوِّج	N	married
عَدى	V	cause_infection
دِكَّة	N	bench
هَبَط-ُِ	V	descend
لِفت	N	elevator
اَصَنصَير	N	elevator
كُوع	N	elbow
مُتَخالِف	ADJ	contradict
تَواجَد	V	exist
مُدرِك	ADJ	knowing
حِزَن	V	grieve
سَمِع	V	hear
اَجَّر	V	be_lent
مَدخُول	N	income
تَنَحنَح	V	hem
تَوَتَّر	V	be_tension
بَياخَة	N	stupidity
ضابِط	N	controller
مُكافحَة	N	battle
مُخَدِّر	N	anesthetic
اِنشَرَى	V	be_bought
اِدَّارَك	V	correct
رَبكَة	N	confusion
ذَرَّة	N	particle
سِلعَة	N	commodity
عَرَض	V	review
عَيبَة	N	blemish
اَمِين	ADJ	loyal
رَسمِيّ	ADJ	official
تَسابُق	N	racing
حُمر	N	redness
نُوت	N	note
محَشِّش	ADJ	drug_abuser
شِعرِيّ	ADJ	poetic
صايِن	ADJ	protecting
مِيعاد	N	appointed_time
مَضنُون	ADJ	competed_in
مَغرُوم	ADJ	fond
جُزئِيَّة	N	particle
مَوهِبَة	N	gift
خَرابِيط	N	nonsense
اِستَهدَى	V	calm_down
خَشَبَة	N	stage
مَسكَن	N	houses
مِرابِع	ADJ	taking_as_a_friend
مِرسال	N	messenger
قَرسُون	N	waiter
صَرَط	V	gulp
عُدوَى	N	hostile_action
شَرح	N	explanation
مِغَيَّر	ADJ	changing
حِذفار	N	side
فَرَّط	V	be_lax
اَدرَى	ADJ	most_knowledgeable
حَزَّ	V	cut
زَعُّول	ADJ	rebellious
غَدَّى	V	feed
مِفَلِّس	ADJ	insolvent
رَصِيد	N	fund
فَكَّ	V	separate
سَكَّن	V	make_stay
مِطَرَّش	ADJ	sending
اِنغَلَب	V	be_defeated
صِيام	N	abstinence
مُعَدَّل	N	average
سَعي	N	in_an_effort_(to)
مِوَصَّل	ADJ	make_reach
مِضَيَّق	ADJ	annoyed
مَلاك	N	angel
بَدَوِي	ADJ	bedouin
لَوزِيّ	ADJ	almond-shaped
تَبَلَّم	V	get_the_wind_up
مَشرُوع	N	enterprise
تَحَجَّب	V	conceal
ظَنَّ	V	think
بُرُوجِكت	N	project
دِراسِي	ADJ	educational
اِدارَة	N	management
اِثبات	N	confirmation
اَخِصّائِيّ	N	expert
مُتَواجِد	ADJ	available
اَشغَل	V	occupy
نِواح	N	mourning
مُغمَى	ADJ	unconscious
رَكعَة	N	genuflection
مُخلِص	ADJ	loyal
اَجهَد	V	strain
لَخَّص	V	summarize
اَلَحّ	V	bother
عَطِش	V	long_for
نُزُول	N	descent
اَصَحّ	ADJ	most_correct
شَبَّع	V	satiate
اِتحَرَق	V	be_burned
اَربَك	V	confuse
مِضَيَّع	N	squandering
دارَك	V	overtake
دَوّار	N	rotation
فاجَأَ	V	surprise
اِعدادِيَّة	N	preparatory_school
اِنطَبَع	V	be_stamped
ضَرُورِيّ	ADJ	necessary
اِتعَذَّر	V	be_hard_pressed
لَمَّة	N	visit
تَغَزُّل	N	flirtation
خُلُق	ADJ	character
رابِع	V	take_as_a_friend
لَعُوبِي	ADJ	flirtatious
نِجِس	ADJ	unclean
مُؤمِن	N	believer
نَذل	ADJ	scoundrel
حاسّ	ADJ	feeling
غَلِيل	N	pique
مِشواة	N	gridiron
مَخدُوع	ADJ	cheated
تَقَرُّب	N	approximation
بَصَلَة	N	an_onion
ناب	V	get
اِكتَمَل	V	be_completed
مُكَيِّف	N	air_condition
حَقُود	ADJ	spiteful
نَجم	N	star
اَحصَى	V	be_counted
اَعَدّ	V	prepare
تَرجَمَة	N	interpretation
رِمال	N	sand
صَحراء	N	desert
مُتَعَطِّش	ADJ	thirsty
مَظلُوم	N	victim_of_oppression_or_injustice
سَطَّر	V	draw_up
فاق	V	excel
اِنحَفَر	V	be_drilled
مَدَى	N	extent
ذَوَّق	V	make_taste
عَبد	N	slave
جازَى	V	reward
بِشارَة	N	good_news
عَفُوّ	ADJ	forgiving
تابِع	ADJ	subordinate
تِجاه	N	toward
صَرِيح	ADJ	candid
خُضرَة	N	greenery
مَغرِبِيّ	ADJ	moroccan
مَدمُوج	ADJ	mixed
صَفَوِيّ	ADJ	safavid
اَيشادَو	N	eye_shadow
تِركِوازِي	ADJ	turquoise
بادِي	ADJ	starting
كَرُّوشَة	N	paunch
مِتمَكيَج	ADJ	with_full_make_up
مَعالِي	N	excellency
حَرّ	ADJ	heat
تَلَوَّن	V	coloration
اِثنَين	N	two
فَوات	N	expiration
اَوان	N	times
تَخَرُّج	N	graduation
مُحتَشِر	ADJ	assembling
مُحايِد	ADJ	neutral
غافِل	ADJ	negligent
تَأثِير	N	effect
اَفضَل	ADJ	better
صَحصَحَ	V	be_active
خَرَج	V	exit
سَوِيَّة	N	machination
اَخيَر	ADJ	better
فُضُولِي	ADJ	curious
مُلتَحِي	ADJ	bearded
مِرَكِّب	ADJ	putting_together
مِدَخَن	N	chimney
جَمر	N	ember
قِدر	N	cooking_pot
مَجبُوس	N	rice_and_checken
مِصَفَّف	ADJ	arranged
طابُوق	N	brick
كِذا	N	many
عُزُومَة	N	invitation
سِوار	N	bracelet
تَوَهَّق	V	be_attached
كَبَّ	V	shed
اَولَى	ADJ	taking_precedence
اِرضاء	N	fulfillment
فَضحَة	N	a_scandal
خَيَّر	V	make
تَهادَى	V	convey_to_each_other
اَهوَن	ADJ	most_easy
شَخبَط	V	scrawl
تهاوَن	V	be_indifferent_toward
سبِيكَر	N	speaker
اِسبِيكَر	N	speaker
تَعَذَّر	V	excuse
اَذَلَّ	V	subdue
تَفَرَّع	V	branch_out
كَراهِيَة	N	antipathy
مَلِك	N	queen
مُغازَلَة	N	courtship
جِسر	N	(reinforcement)_beam_or_bar
خَشَع	V	be_humble
اِستَجاب	V	be_replied_to
نِمرَة	N	number
سِين	N	question
جِيم	N	jim_(arabic_letter)
صاقِع	ADJ	hot
تِفَشَّل	V	wear
مَخفِي	ADJ	hidden
مَوجِع	N	pain
واو	N	waw_(arabic_letter)
تَفَقَّد	V	examine
رَخِيص	ADJ	cheap
ثانيَة	N	next
اصاب	V	afflict
مِتعَدِّل	ADJ	outfitted
تَصبِيب	N	pouring
تَقصِيص	N	cutting
اَشرَف	V	be_supervised
هامِم	ADJ	interested
حَلَق	N	earring
حَرَم	N	wife
اِتكَرَّر	V	give_back
ذَبح	N	slaughtering
ال	N	family
اَجمَع	N	whole
اَسعَد	V	make_happy
نِداء	N	call
خَلِيل	N	friend
غَمّ	N	distress
جالَس	V	sit_with
مَتَّع	V	make_enjoy
تِلو	N	after
صَدَى	N	echo
قاهِر	ADJ	overpowering
لَبَن	N	dairy_products
عَصفُور	N	bird
تَضَرَّر	V	be_injured
هَزَّأ	V	be_mocked
تَهزِيء	N	rebuke
اَعمَى	V	make_blind
قُدوَة	N	pattern
اَكرَم	ADJ	dearest
تَدَخَّل	V	interfere
مُقَدَّر	ADJ	fate
نَهر	N	river
بارِي	N	creator
اَعقَل	V	tie
اِتَّبَعَ	V	pursue
نِجم	N	star
تَلَألَأ	V	sparkle
شَكوَة	N	complaint
مَبسَم	N	mouthpiece
حادِي	N	leader
صَرَّح	V	declare
خِرِّيج	N	graduate
أَخطَأ	V	
خَطَّاء	ADJ	mistaken
تَوَّاب	N	repentant
لاغِي	ADJ	abrogated
سَنَد	N	support
نَبَّأ	V	inform
صَحّ	N	correct
عَقلانِيَّة	N	rationality
قاع	N	depth
غَوص	N	diving
خَوض	N	embarking_on
خاض	V	embark
مَعرَكَة	N	battle
اِنطَعَن	V	be_stabbed
عَقَّل	V	make_reasonable
اِطَّمِّن	V	calm_down
اِستَفاد	V	benifit
بَسبَس	V	say_"bas_bas"
اِعتِراف	N	confession
مُلَثَّم	ADJ	masked
حَذَف	V	delete
سَعَى	V	strive
عِشرة	N	association
مَنطِق	N	logic
تَواضَع	V	be_humble
اِشاعَة	N	rumor
جَزا	N	reward
تَفَهُّم	N	understanding
فَطِيرَة	N	pastry
تَشَتَّت	V	be_dispersed
تَمَلُّك	N	seizure
رافِض	ADJ	refusing
فَرد	N	unit
وارِث	N	inheritor
مِعذار	N	excuses
اَبطا	V	be_slow
لُقيا	N	encountering
فُرقَى	N	separation
كَبَّر	V	make_older
مِياه	N	water
مَجرَى	N	courses
ظَفَر	V	succeed
طَعنَة	N	stab
تَهَوُّر	N	rashness
رايم	ADJ	wanting
زُجاجِيّ	ADJ	glass
مِفَكَّر	ADJ	intellectual
كَدَّر	V	roil
ذَلِيل	ADJ	despised
جَلَّس	V	make_sit
اِنطِلاق	N	proceeding_(from)
اِنطَلَق	V	take_off
ضَنا	N	son
اِصبُوع	N	finger
سَوِي	ADJ	equal
مِعَلِّم	ADJ	teaching
تُقل	N	heaviness
دَرَج	V	stair
رَسُول	N	messenger_(muhammad)
ءاتَى	V	give
دُنيا	N	world
حَسَنَة	N	reward
ءاخِرَة	N	doomsday
وَقَى	V	keep
مُعَقِّد	ADJ	complicating
دُكتُر	N	doctor
لان	V	be_flexible
تَأيِيد	N	approval
واوا	N	boo-boo
تَعَلَّق	V	relate
مِحَيَّر	ADJ	amazing
مِتوَصِّف	ADJ	describer
مِهَبِّل	ADJ	naive
اِبتَكَر	V	originate
مَجزَرَة	N	massacre
مَكرُوه	ADJ	detested
جَماعَة	N	squad
خَطَب	N	engage
سَواء	N	whether
زَعَّل	V	make_sad
ثانِي	N	other
سَبَّة	N	insult
عَتبان	ADJ	blaming
رابِط	N	link
تَغاضَى	V	disregard
مُعتَرِض	ADJ	lying_across
تَلمِيح	N	references
اِصرار	N	determination
اِنظَلَم	V	be_wronged
طايِش	ADJ	rash
مِتخَشِّع	ADJ	humbled
نَظَر	V	see
مُبارَك	ADJ	blessed
